YEAR,UNITID,CIPCODE,MAJORNUM,AWLEVEL,CTOTALT,CTOTALM,CTOTALW,CAIANT,CAIANM,CAIANW,CASIAT,CASIAM,CASIAW,CBKAAT,CBKAAM,CBKAAW,CHISPT,CHISPM,CHISPW,CNHPIT,CNHPIM,CNHPIW,CWHITT,CWHITM,CWHITW,C2MORT,C2MORM,C2MORW,CUNKNT,CUNKNM,CUNKNW,CNRALT,CNRALM,CNRALW  
2020,194824,Environmental Science,1,Bachelor's degree,4,0,4,0,0,0,0,0,0,0,0,0,1,0,1,0,0,0,3,0,3,0,0,0,0,0,0,0,0,0
2020,194824,Architecture,1,Bachelor's degree,42,19,23,0,0,0,3,2,1,2,0,2,7,2,5,0,0,0,18,8,10,2,1,1,1,0,1,9,6,3
2020,194824,Architecture,1,Master's degree,12,7,5,0,0,0,0,0,0,0,0,0,1,0,1,0,0,0,8,5,3,1,1,0,0,0,0,2,1,1
2020,194824,Architectural and Building Sciences/Technology,1,Bachelor's degree,2,1,1,0,0,0,0,0,0,0,0,0,1,0,1,0,0,0,0,0,0,1,1,0,0,0,0,0,0,0
2020,194824,Architectural and Building Sciences/Technology,1,Master's degree,13,6,7,0,0,0,0,0,0,1,1,0,1,1,0,0,0,0,7,3,4,1,0,1,1,1,0,2,0,2
2020,194824,"Architecture and Related Services, Other",1,Bachelor's degree,0,0,0,0,0,0,0,0,0,0,0,0,0,0,0,0,0,0,0,0,0,0,0,0,0,0,0,0,0,0
2020,194824,"Architecture and Related Services, Other",1,Master's degree,7,4,3,0,0,0,0,0,0,0,0,0,0,0,0,0,0,0,3,2,1,0,0,0,0,0,0,4,2,2
2020,194824,"Communication, General",1,Bachelor's degree,3,1,2,0,0,0,0,0,0,1,1,0,0,0,0,0,0,0,2,0,2,0,0,0,0,0,0,0,0,0
2020,194824,Speech Communication and Rhetoric,1,Bachelor's degree,0,0,0,0,0,0,0,0,0,0,0,0,0,0,0,0,0,0,0,0,0,0,0,0,0,0,0,0,0,0
2020,194824,Speech Communication and Rhetoric,1,Master's degree,1,1,0,0,0,0,0,0,0,0,0,0,0,0,0,0,0,0,0,0,0,0,0,0,0,0,0,1,1,0
2020,194824,Digital Communication and Media/Multimedia,1,Bachelor's degree,7,5,2,0,0,0,0,0,0,1,1,0,0,0,0,0,0,0,5,3,2,0,0,0,0,0,0,1,1,0
2020,194824,Technical and Scientific Communication,1,Master's degree,0,0,0,0,0,0,0,0,0,0,0,0,0,0,0,0,0,0,0,0,0,0,0,0,0,0,0,0,0,0
2020,194824,"Computer and Information Sciences, General",1,Bachelor's degree,0,0,0,0,0,0,0,0,0,0,0,0,0,0,0,0,0,0,0,0,0,0,0,0,0,0,0,0,0,0
2020,194824,"Computer and Information Sciences, General",1,Master's degree,0,0,0,0,0,0,0,0,0,0,0,0,0,0,0,0,0,0,0,0,0,0,0,0,0,0,0,0,0,0
2020,194824,Information Technology,1,Bachelor's degree,24,20,4,0,0,0,1,1,0,0,0,0,5,3,2,0,0,0,11,10,1,3,2,1,0,0,0,4,4,0
2020,194824,Information Technology,1,Master's degree,25,15,10,0,0,0,0,0,0,0,0,0,1,0,1,0,0,0,5,3,2,0,0,0,1,1,0,18,11,7
2020,194824,Computer Science,1,Bachelor's degree,255,210,45,0,0,0,41,31,10,7,5,2,19,12,7,0,0,0,118,106,12,22,17,5,5,5,0,43,34,9
2020,194824,Computer Science,1,Master's degree,26,23,3,0,0,0,6,4,2,1,1,0,2,2,0,0,0,0,11,11,0,0,0,0,0,0,0,6,5,1
2020,194824,"Aerospace, Aeronautical, and Astronautical/Space Engineering, General",1,Bachelor's degree,101,83,18,0,0,0,9,7,2,3,3,0,15,11,4,0,0,0,65,54,11,4,4,0,0,0,0,5,4,1
2020,194824,"Aerospace, Aeronautical, and Astronautical/Space Engineering, General",1,Master's degree,11,8,3,0,0,0,2,2,0,0,0,0,1,1,0,0,0,0,6,3,3,0,0,0,1,1,0,1,1,0
2020,194824,Bioengineering and Biomedical Engineering,1,Bachelor's degree,102,48,54,0,0,0,20,10,10,1,1,0,10,8,2,1,0,1,56,21,35,9,4,5,0,0,0,5,4,1
2020,194824,Bioengineering and Biomedical Engineering,1,Master's degree,14,4,10,0,0,0,1,0,1,0,0,0,3,1,2,0,0,0,9,3,6,0,0,0,0,0,0,1,0,1
2020,194824,Chemical Engineering,1,Bachelor's degree,109,56,53,0,0,0,17,7,10,5,4,1,12,6,6,0,0,0,59,31,28,9,4,5,0,0,0,7,4,3
2020,194824,Chemical Engineering,1,Master's degree,3,2,1,0,0,0,0,0,0,0,0,0,0,0,0,0,0,0,1,1,0,1,0,1,0,0,0,1,1,0
2020,194824,"Civil Engineering, General",1,Bachelor's degree,70,45,25,0,0,0,3,1,2,4,3,1,7,5,2,0,0,0,47,30,17,3,2,1,2,2,0,4,2,2
2020,194824,"Civil Engineering, General",1,Master's degree,14,7,7,0,0,0,1,0,1,0,0,0,0,0,0,0,0,0,13,7,6,0,0,0,0,0,0,0,0,0
2020,194824,Transportation and Highway Engineering,1,Master's degree,2,2,0,0,0,0,1,1,0,0,0,0,0,0,0,0,0,0,0,0,0,0,0,0,0,0,0,1,1,0
2020,194824,Electrical and Electronics Engineering,1,Bachelor's degree,91,68,23,0,0,0,10,6,4,3,3,0,8,7,1,0,0,0,37,27,10,7,5,2,2,1,1,24,19,5
2020,194824,Electrical and Electronics Engineering,1,Master's degree,17,15,2,0,0,0,1,0,1,1,1,0,0,0,0,0,0,0,5,4,1,0,0,0,0,0,0,10,10,0
2020,194824,Engineering Physics/Applied Physics,1,Bachelor's degree,0,0,0,0,0,0,0,0,0,0,0,0,0,0,0,0,0,0,0,0,0,0,0,0,0,0,0,0,0,0
2020,194824,Engineering Physics/Applied Physics,1,Master's degree,0,0,0,0,0,0,0,0,0,0,0,0,0,0,0,0,0,0,0,0,0,0,0,0,0,0,0,0,0,0
2020,194824,Engineering Science,1,Bachelor's degree,1,1,0,0,0,0,0,0,0,0,0,0,0,0,0,0,0,0,1,1,0,0,0,0,0,0,0,0,0,0
2020,194824,Engineering Science,1,Master's degree,0,0,0,0,0,0,0,0,0,0,0,0,0,0,0,0,0,0,0,0,0,0,0,0,0,0,0,0,0,0
2020,194824,Environmental/Environmental Health Engineering,1,Bachelor's degree,14,5,9,0,0,0,1,0,1,1,0,1,0,0,0,0,0,0,12,5,7,0,0,0,0,0,0,0,0,0
2020,194824,Environmental/Environmental Health Engineering,1,Master's degree,1,0,1,0,0,0,0,0,0,0,0,0,0,0,0,0,0,0,1,0,1,0,0,0,0,0,0,0,0,0
2020,194824,Materials Engineering,1,Bachelor's degree,26,15,11,0,0,0,3,0,3,0,0,0,1,0,1,0,0,0,11,8,3,4,2,2,0,0,0,7,5,2
2020,194824,Materials Engineering,1,Master's degree,9,5,4,0,0,0,0,0,0,0,0,0,1,1,0,0,0,0,3,2,1,4,2,2,0,0,0,1,0,1
2020,194824,Mechanical Engineering,1,Bachelor's degree,233,175,58,0,0,0,19,14,5,7,6,1,31,26,5,0,0,0,137,98,39,11,8,3,6,3,3,22,20,2
2020,194824,Mechanical Engineering,1,Master's degree,33,22,11,0,0,0,4,2,2,2,2,0,2,2,0,0,0,0,17,11,6,3,2,1,0,0,0,5,3,2
2020,194824,Nuclear Engineering,1,Bachelor's degree,30,23,7,0,0,0,1,1,0,0,0,0,2,2,0,0,0,0,21,15,6,3,3,0,0,0,0,3,2,1
2020,194824,Nuclear Engineering,1,Master's degree,2,2,0,0,0,0,0,0,0,0,0,0,0,0,0,0,0,0,1,1,0,0,0,0,1,1,0,0,0,0
2020,194824,Systems Engineering,1,Master's degree,6,3,3,0,0,0,2,1,1,0,0,0,0,0,0,0,0,0,4,2,2,0,0,0,0,0,0,0,0,0
2020,194824,Industrial Engineering,1,Bachelor's degree,54,31,23,0,0,0,6,3,3,3,3,0,9,4,5,0,0,0,28,17,11,2,1,1,1,0,1,5,3,2
2020,194824,Industrial Engineering,1,Master's degree,4,2,2,0,0,0,0,0,0,1,0,1,0,0,0,0,0,0,1,0,1,0,0,0,0,0,0,2,2,0
2020,194824,Operations Research,1,Master's degree,0,0,0,0,0,0,0,0,0,0,0,0,0,0,0,0,0,0,0,0,0,0,0,0,0,0,0,0,0,0
2020,194824,Computer/Computer Systems Technology/Technician,1,Bachelor's degree,74,61,13,0,0,0,10,9,1,0,0,0,5,5,0,0,0,0,44,35,9,3,3,0,0,0,0,12,9,3
2020,194824,Computer/Computer Systems Technology/Technician,1,Master's degree,6,5,1,0,0,0,1,1,0,0,0,0,0,0,0,0,0,0,1,1,0,1,0,1,0,0,0,3,3,0
2020,194824,Pre-Law Studies,1,Bachelor's degree,0,0,0,0,0,0,0,0,0,0,0,0,0,0,0,0,0,0,0,0,0,0,0,0,0,0,0,0,0,0
2020,194824,"Biology/Biological Sciences, General",1,Bachelor's degree,20,6,14,0,0,0,1,0,1,2,1,1,1,0,1,0,0,0,14,4,10,1,1,0,1,0,1,0,0,0
2020,194824,"Biology/Biological Sciences, General",1,Master's degree,0,0,0,0,0,0,0,0,0,0,0,0,0,0,0,0,0,0,0,0,0,0,0,0,0,0,0,0,0,0
2020,194824,Biochemistry and Molecular Biology,1,Bachelor's degree,0,0,0,0,0,0,0,0,0,0,0,0,0,0,0,0,0,0,0,0,0,0,0,0,0,0,0,0,0,0
2020,194824,Biochemistry and Molecular Biology,1,Master's degree,0,0,0,0,0,0,0,0,0,0,0,0,0,0,0,0,0,0,0,0,0,0,0,0,0,0,0,0,0,0
2020,194824,"Biochemistry, Biophysics and Molecular Biology, Other",1,Bachelor's degree,18,7,11,0,0,0,0,0,0,0,0,0,3,2,1,0,0,0,11,3,8,1,0,1,0,0,0,3,2,1
2020,194824,"Biochemistry, Biophysics and Molecular Biology, Other",1,Master's degree,1,0,1,0,0,0,1,0,1,0,0,0,0,0,0,0,0,0,0,0,0,0,0,0,0,0,0,0,0,0
2020,194824,Bioinformatics,1,Bachelor's degree,7,4,3,0,0,0,1,0,1,0,0,0,0,0,0,0,0,0,4,3,1,2,1,1,0,0,0,0,0,0
2020,194824,"Biological and Biomedical Sciences, Other",1,Bachelor's degree,0,0,0,0,0,0,0,0,0,0,0,0,0,0,0,0,0,0,0,0,0,0,0,0,0,0,0,0,0,0
2020,194824,"Mathematics, General",1,Bachelor's degree,66,44,22,0,0,0,6,6,0,1,1,0,1,0,1,0,0,0,25,16,9,1,1,0,0,0,0,32,20,12
2020,194824,"Mathematics, General",1,Master's degree,0,0,0,0,0,0,0,0,0,0,0,0,0,0,0,0,0,0,0,0,0,0,0,0,0,0,0,0,0,0
2020,194824,"Applied Mathematics, General",1,Master's degree,14,12,2,0,0,0,0,0,0,0,0,0,1,1,0,0,0,0,7,6,1,0,0,0,0,0,0,6,5,1
2020,194824,Financial Mathematics,1,Master's degree,65,38,27,0,0,0,2,1,1,0,0,0,1,0,1,0,0,0,3,2,1,0,0,0,0,0,0,59,35,24
2020,194824,"Multi-/Interdisciplinary Studies, General",1,Bachelor's degree,0,0,0,0,0,0,0,0,0,0,0,0,0,0,0,0,0,0,0,0,0,0,0,0,0,0,0,0,0,0
2020,194824,"Multi-/Interdisciplinary Studies, General",1,Master's degree,0,0,0,0,0,0,0,0,0,0,0,0,0,0,0,0,0,0,0,0,0,0,0,0,0,0,0,0,0,0
2020,194824,"Science, Technology and Society",1,Bachelor's degree,5,1,4,0,0,0,0,0,0,0,0,0,0,0,0,0,0,0,4,1,3,1,0,1,0,0,0,0,0,0
2020,194824,"Science, Technology and Society",1,Master's degree,2,1,1,0,0,0,1,0,1,0,0,0,0,0,0,0,0,0,1,1,0,0,0,0,0,0,0,0,0,0
2020,194824,Natural Sciences,1,Master's degree,0,0,0,0,0,0,0,0,0,0,0,0,0,0,0,0,0,0,0,0,0,0,0,0,0,0,0,0,0,0
2020,194824,"Cognitive Science, General",1,Bachelor's degree,3,1,2,0,0,0,0,0,0,0,0,0,0,0,0,0,0,0,0,0,0,1,0,1,0,0,0,2,1,1
2020,194824,"Cognitive Science, General",1,Master's degree,6,3,3,0,0,0,0,0,0,0,0,0,0,0,0,0,0,0,3,3,0,0,0,0,0,0,0,3,0,3
2020,194824,Human Computer Interaction,1,Master's degree,0,0,0,0,0,0,0,0,0,0,0,0,0,0,0,0,0,0,0,0,0,0,0,0,0,0,0,0,0,0
2020,194824,Sustainability Studies,1,Bachelor's degree,3,0,3,0,0,0,0,0,0,1,0,1,1,0,1,0,0,0,1,0,1,0,0,0,0,0,0,0,0,0
2020,194824,Business Analytics,1,Bachelor's degree,1,1,0,0,0,0,1,1,0,0,0,0,0,0,0,0,0,0,0,0,0,0,0,0,0,0,0,0,0,0
2020,194824,"Multi-/Interdisciplinary Studies, Other",1,Bachelor's degree,18,9,9,1,0,1,1,1,0,1,0,1,2,1,1,0,0,0,9,5,4,2,1,1,0,0,0,2,1,1
2020,194824,"Multi-/Interdisciplinary Studies, Other",1,Master's degree,0,0,0,0,0,0,0,0,0,0,0,0,0,0,0,0,0,0,0,0,0,0,0,0,0,0,0,0,0,0
2020,194824,Philosophy,1,Bachelor's degree,1,0,1,0,0,0,0,0,0,0,0,0,0,0,0,0,0,0,1,0,1,0,0,0,0,0,0,0,0,0
2020,194824,Philosophy,1,Master's degree,0,0,0,0,0,0,0,0,0,0,0,0,0,0,0,0,0,0,0,0,0,0,0,0,0,0,0,0,0,0
2020,194824,Astronomy,1,Master's degree,1,1,0,0,0,0,0,0,0,0,0,0,0,0,0,0,0,0,1,1,0,0,0,0,0,0,0,0,0,0
2020,194824,"Chemistry, General",1,Bachelor's degree,9,4,5,0,0,0,1,1,0,0,0,0,0,0,0,0,0,0,5,2,3,2,0,2,0,0,0,1,1,0
2020,194824,"Chemistry, General",1,Master's degree,3,2,1,0,0,0,0,0,0,0,0,0,1,1,0,0,0,0,1,1,0,1,0,1,0,0,0,0,0,0
2020,194824,"Geology/Earth Science, General",1,Bachelor's degree,2,1,1,0,0,0,0,0,0,0,0,0,0,0,0,0,0,0,1,1,0,0,0,0,1,0,1,0,0,0
2020,194824,"Geology/Earth Science, General",1,Master's degree,1,1,0,0,0,0,0,0,0,0,0,0,0,0,0,0,0,0,0,0,0,0,0,0,0,0,0,1,1,0
2020,194824,Hydrology and Water Resources Science,1,Bachelor's degree,0,0,0,0,0,0,0,0,0,0,0,0,0,0,0,0,0,0,0,0,0,0,0,0,0,0,0,0,0,0
2020,194824,Hydrology and Water Resources Science,1,Master's degree,0,0,0,0,0,0,0,0,0,0,0,0,0,0,0,0,0,0,0,0,0,0,0,0,0,0,0,0,0,0
2020,194824,"Physics, General",1,Bachelor's degree,28,27,1,0,0,0,3,3,0,0,0,0,1,1,0,0,0,0,22,22,0,1,0,1,0,0,0,1,1,0
2020,194824,"Physics, General",1,Master's degree,8,7,1,0,0,0,0,0,0,0,0,0,0,0,0,0,0,0,7,6,1,0,0,0,0,0,0,1,1,0
2020,194824,"Physics, Other",1,Bachelor's degree,16,7,9,0,0,0,0,0,0,1,0,1,1,0,1,0,0,0,11,5,6,1,0,1,0,0,0,2,2,0
2020,194824,"Physical Sciences, Other",1,Bachelor's degree,0,0,0,0,0,0,0,0,0,0,0,0,0,0,0,0,0,0,0,0,0,0,0,0,0,0,0,0,0,0
2020,194824,"Physical Sciences, Other",1,Master's degree,0,0,0,0,0,0,0,0,0,0,0,0,0,0,0,0,0,0,0,0,0,0,0,0,0,0,0,0,0,0
2020,194824,"Psychology, General",1,Bachelor's degree,6,2,4,0,0,0,0,0,0,0,0,0,0,0,0,0,0,0,4,0,4,0,0,0,1,1,0,1,1,0
2020,194824,"Psychology, General",1,Master's degree,0,0,0,0,0,0,0,0,0,0,0,0,0,0,0,0,0,0,0,0,0,0,0,0,0,0,0,0,0,0
2020,194824,"Social Sciences, General",1,Bachelor's degree,0,0,0,0,0,0,0,0,0,0,0,0,0,0,0,0,0,0,0,0,0,0,0,0,0,0,0,0,0,0
2020,194824,"Social Sciences, General",1,Master's degree,0,0,0,0,0,0,0,0,0,0,0,0,0,0,0,0,0,0,0,0,0,0,0,0,0,0,0,0,0,0
2020,194824,"Economics, General",1,Bachelor's degree,4,4,0,0,0,0,0,0,0,0,0,0,0,0,0,0,0,0,4,4,0,0,0,0,0,0,0,0,0,0
2020,194824,"Economics, General",1,Master's degree,3,1,2,0,0,0,0,0,0,1,0,1,0,0,0,0,0,0,1,1,0,0,0,0,0,0,0,1,0,1
2020,194824,"Economics, Other",1,Master's degree,0,0,0,0,0,0,0,0,0,0,0,0,0,0,0,0,0,0,0,0,0,0,0,0,0,0,0,0,0,0
2020,194824,"Social Sciences, Other",1,Master's degree,0,0,0,0,0,0,0,0,0,0,0,0,0,0,0,0,0,0,0,0,0,0,0,0,0,0,0,0,0,0
2020,194824,"Visual and Performing Arts, General",1,Bachelor's degree,3,1,2,0,0,0,0,0,0,0,0,0,1,0,1,0,0,0,1,1,0,1,0,1,0,0,0,0,0,0
2020,194824,"Visual and Performing Arts, General",1,Master's degree,0,0,0,0,0,0,0,0,0,0,0,0,0,0,0,0,0,0,0,0,0,0,0,0,0,0,0,0,0,0
2020,194824,Game and Interactive Media Design,1,Bachelor's degree,36,24,12,0,0,0,2,1,1,2,2,0,3,3,0,0,0,0,19,14,5,2,1,1,0,0,0,8,3,5
2020,194824,Music Theory and Composition,1,Bachelor's degree,0,0,0,0,0,0,0,0,0,0,0,0,0,0,0,0,0,0,0,0,0,0,0,0,0,0,0,0,0,0
2020,194824,Pre-Medicine/Pre-Medical Studies,1,Bachelor's degree,9,4,5,0,0,0,5,2,3,0,0,0,0,0,0,0,0,0,2,1,1,2,1,1,0,0,0,0,0,0
2020,194824,"Business Administration and Management, General",1,Bachelor's degree,76,55,21,0,0,0,11,9,2,3,3,0,7,6,1,0,0,0,38,25,13,7,5,2,1,1,0,9,6,3
2020,194824,"Business Administration and Management, General",1,Master's degree,15,7,8,0,0,0,0,0,0,1,0,1,0,0,0,0,0,0,9,7,2,1,0,1,0,0,0,4,0,4
2020,194824,"Logistics, Materials, and Supply Chain Management",1,Master's degree,0,0,0,0,0,0,0,0,0,0,0,0,0,0,0,0,0,0,0,0,0,0,0,0,0,0,0,0,0,0
2020,194824,Entrepreneurship/Entrepreneurial Studies,1,Master's degree,14,8,6,0,0,0,0,0,0,1,1,0,2,2,0,0,0,0,9,4,5,1,0,1,0,0,0,1,1,0
2020,194824,"Finance and Financial Management Services, Other",1,Master's degree,0,0,0,0,0,0,0,0,0,0,0,0,0,0,0,0,0,0,0,0,0,0,0,0,0,0,0,0,0,0
2020,194824,Business Statistics,1,Master's degree,45,25,20,0,0,0,5,4,1,2,1,1,2,2,0,0,0,0,5,3,2,2,1,1,0,0,0,29,14,15
2020,194824,"Management Sciences and Quantitative Methods, Other",1,Master's degree,6,1,5,0,0,0,0,0,0,0,0,0,0,0,0,0,0,0,0,0,0,1,1,0,0,0,0,5,0,5
2020,194824,"Business, Management, Marketing, and Related Support Services, Other",1,Master's degree,0,0,0,0,0,0,0,0,0,0,0,0,0,0,0,0,0,0,0,0,0,0,0,0,0,0,0,0,0,0
2020,194824,99,1,Bachelor's degree,1573,1069,504,1,0,1,176,116,60,49,37,12,154,104,50,1,0,1,851,576,275,108,68,40,21,13,8,212,155,57
2020,194824,99,1,Master's degree,390,240,150,0,0,0,28,16,12,11,7,4,19,14,5,0,0,0,143,94,49,17,7,10,4,4,0,168,98,70
2021,194824,Environmental Science,1,Bachelor's degree,3,0,3,0,0,0,0,0,0,0,0,0,0,0,0,0,0,0,3,0,3,0,0,0,0,0,0,0,0,0
2021,194824,Architecture,1,Bachelor's degree,56,20,36,0,0,0,9,2,7,2,0,2,10,5,5,0,0,0,27,9,18,2,1,1,1,1,0,5,2,3
2021,194824,Architecture,1,Master's degree,4,2,2,0,0,0,0,0,0,0,0,0,1,0,1,0,0,0,0,0,0,0,0,0,1,1,0,2,1,1
2021,194824,Architectural and Building Sciences/Technology,1,Bachelor's degree,1,1,0,0,0,0,0,0,0,0,0,0,0,0,0,0,0,0,1,1,0,0,0,0,0,0,0,0,0,0
2021,194824,Architectural and Building Sciences/Technology,1,Master's degree,8,6,2,0,0,0,0,0,0,0,0,0,0,0,0,0,0,0,4,3,1,0,0,0,1,0,1,3,3,0
2021,194824,"Architecture and Related Services, Other",1,Bachelor's degree,0,0,0,0,0,0,0,0,0,0,0,0,0,0,0,0,0,0,0,0,0,0,0,0,0,0,0,0,0,0
2021,194824,"Architecture and Related Services, Other",1,Master's degree,3,1,2,0,0,0,0,0,0,0,0,0,0,0,0,0,0,0,3,1,2,0,0,0,0,0,0,0,0,0
2021,194824,"Communication, General",1,Bachelor's degree,4,0,4,0,0,0,0,0,0,0,0,0,0,0,0,0,0,0,3,0,3,0,0,0,0,0,0,1,0,1
2021,194824,Speech Communication and Rhetoric,1,Bachelor's degree,0,0,0,0,0,0,0,0,0,0,0,0,0,0,0,0,0,0,0,0,0,0,0,0,0,0,0,0,0,0
2021,194824,Speech Communication and Rhetoric,1,Master's degree,1,1,0,0,0,0,0,0,0,0,0,0,0,0,0,0,0,0,1,1,0,0,0,0,0,0,0,0,0,0
2021,194824,Digital Communication and Media/Multimedia,1,Bachelor's degree,5,2,3,0,0,0,0,0,0,0,0,0,2,1,1,0,0,0,0,0,0,1,1,0,0,0,0,2,0,2
2021,194824,Technical and Scientific Communication,1,Master's degree,0,0,0,0,0,0,0,0,0,0,0,0,0,0,0,0,0,0,0,0,0,0,0,0,0,0,0,0,0,0
2021,194824,"Computer and Information Sciences, General",1,Bachelor's degree,0,0,0,0,0,0,0,0,0,0,0,0,0,0,0,0,0,0,0,0,0,0,0,0,0,0,0,0,0,0
2021,194824,"Computer and Information Sciences, General",1,Master's degree,0,0,0,0,0,0,0,0,0,0,0,0,0,0,0,0,0,0,0,0,0,0,0,0,0,0,0,0,0,0
2021,194824,Information Technology,1,Bachelor's degree,32,27,5,0,0,0,8,6,2,1,0,1,2,2,0,0,0,0,13,13,0,2,1,1,0,0,0,6,5,1
2021,194824,Information Technology,1,Master's degree,61,38,23,0,0,0,4,4,0,0,0,0,3,3,0,0,0,0,5,4,1,0,0,0,0,0,0,49,27,22
2021,194824,Computer Science,1,Bachelor's degree,262,225,37,1,1,0,68,59,9,11,10,1,18,15,3,0,0,0,97,86,11,10,9,1,3,3,0,54,42,12
2021,194824,Computer Science,1,Master's degree,26,23,3,0,0,0,3,2,1,0,0,0,2,2,0,0,0,0,9,9,0,1,1,0,1,1,0,10,8,2
2021,194824,"Aerospace, Aeronautical, and Astronautical/Space Engineering, General",1,Bachelor's degree,114,94,20,1,1,0,7,4,3,4,2,2,11,9,2,0,0,0,79,67,12,4,4,0,2,1,1,6,6,0
2021,194824,"Aerospace, Aeronautical, and Astronautical/Space Engineering, General",1,Master's degree,22,19,3,0,0,0,2,2,0,0,0,0,0,0,0,0,0,0,18,15,3,2,2,0,0,0,0,0,0,0
2021,194824,Bioengineering and Biomedical Engineering,1,Bachelor's degree,105,49,56,0,0,0,15,7,8,6,4,2,8,6,2,0,0,0,62,27,35,6,2,4,3,2,1,5,1,4
2021,194824,Bioengineering and Biomedical Engineering,1,Master's degree,20,13,7,0,0,0,4,3,1,0,0,0,4,3,1,1,0,1,11,7,4,0,0,0,0,0,0,0,0,0
2021,194824,Chemical Engineering,1,Bachelor's degree,74,37,37,0,0,0,9,3,6,1,0,1,5,3,2,0,0,0,47,24,23,5,2,3,2,1,1,5,4,1
2021,194824,Chemical Engineering,1,Master's degree,11,10,1,0,0,0,0,0,0,0,0,0,0,0,0,0,0,0,6,6,0,0,0,0,0,0,0,5,4,1
2021,194824,"Civil Engineering, General",1,Bachelor's degree,62,39,23,0,0,0,7,4,3,2,2,0,6,6,0,0,0,0,39,22,17,4,2,2,2,1,1,2,2,0
2021,194824,"Civil Engineering, General",1,Master's degree,19,12,7,0,0,0,2,1,1,2,2,0,1,1,0,0,0,0,12,6,6,1,1,0,1,1,0,0,0,0
2021,194824,Transportation and Highway Engineering,1,Master's degree,3,2,1,0,0,0,0,0,0,0,0,0,0,0,0,0,0,0,2,2,0,0,0,0,0,0,0,1,0,1
2021,194824,Electrical and Electronics Engineering,1,Bachelor's degree,96,81,15,0,0,0,11,7,4,4,4,0,8,7,1,0,0,0,28,23,5,4,3,1,1,1,0,40,36,4
2021,194824,Electrical and Electronics Engineering,1,Master's degree,25,21,4,0,0,0,2,2,0,0,0,0,1,1,0,0,0,0,6,5,1,3,2,1,0,0,0,13,11,2
2021,194824,Engineering Physics/Applied Physics,1,Bachelor's degree,0,0,0,0,0,0,0,0,0,0,0,0,0,0,0,0,0,0,0,0,0,0,0,0,0,0,0,0,0,0
2021,194824,Engineering Physics/Applied Physics,1,Master's degree,0,0,0,0,0,0,0,0,0,0,0,0,0,0,0,0,0,0,0,0,0,0,0,0,0,0,0,0,0,0
2021,194824,Engineering Science,1,Bachelor's degree,0,0,0,0,0,0,0,0,0,0,0,0,0,0,0,0,0,0,0,0,0,0,0,0,0,0,0,0,0,0
2021,194824,Engineering Science,1,Master's degree,0,0,0,0,0,0,0,0,0,0,0,0,0,0,0,0,0,0,0,0,0,0,0,0,0,0,0,0,0,0
2021,194824,Environmental/Environmental Health Engineering,1,Bachelor's degree,12,7,5,0,0,0,1,1,0,0,0,0,2,1,1,0,0,0,7,3,4,0,0,0,0,0,0,2,2,0
2021,194824,Environmental/Environmental Health Engineering,1,Master's degree,5,2,3,0,0,0,0,0,0,0,0,0,0,0,0,0,0,0,4,2,2,1,0,1,0,0,0,0,0,0
2021,194824,Materials Engineering,1,Bachelor's degree,25,18,7,0,0,0,3,1,2,0,0,0,0,0,0,0,0,0,14,11,3,1,0,1,0,0,0,7,6,1
2021,194824,Materials Engineering,1,Master's degree,5,3,2,0,0,0,1,0,1,0,0,0,0,0,0,0,0,0,2,1,1,1,1,0,0,0,0,1,1,0
2021,194824,Mechanical Engineering,1,Bachelor's degree,239,184,55,0,0,0,27,14,13,9,7,2,19,17,2,0,0,0,119,91,28,16,13,3,6,5,1,43,37,6
2021,194824,Mechanical Engineering,1,Master's degree,38,25,13,0,0,0,2,1,1,1,1,0,4,3,1,0,0,0,19,11,8,1,0,1,0,0,0,11,9,2
2021,194824,Nuclear Engineering,1,Bachelor's degree,18,15,3,0,0,0,2,1,1,0,0,0,2,2,0,0,0,0,11,9,2,1,1,0,1,1,0,1,1,0
2021,194824,Nuclear Engineering,1,Master's degree,2,2,0,0,0,0,0,0,0,0,0,0,1,1,0,0,0,0,1,1,0,0,0,0,0,0,0,0,0,0
2021,194824,Systems Engineering,1,Master's degree,4,4,0,0,0,0,0,0,0,0,0,0,1,1,0,0,0,0,2,2,0,0,0,0,1,1,0,0,0,0
2021,194824,Industrial Engineering,1,Bachelor's degree,54,31,23,0,0,0,8,4,4,3,3,0,9,4,5,0,0,0,26,17,9,2,2,0,1,0,1,5,1,4
2021,194824,Industrial Engineering,1,Master's degree,3,2,1,0,0,0,0,0,0,0,0,0,0,0,0,0,0,0,0,0,0,0,0,0,0,0,0,3,2,1
2021,194824,Operations Research,1,Master's degree,0,0,0,0,0,0,0,0,0,0,0,0,0,0,0,0,0,0,0,0,0,0,0,0,0,0,0,0,0,0
2021,194824,Computer/Computer Systems Technology/Technician,1,Bachelor's degree,76,65,11,0,0,0,18,14,4,4,3,1,6,6,0,0,0,0,30,26,4,1,1,0,1,0,1,16,15,1
2021,194824,Computer/Computer Systems Technology/Technician,1,Master's degree,12,9,3,0,0,0,3,3,0,0,0,0,0,0,0,0,0,0,4,1,3,0,0,0,0,0,0,5,5,0
2021,194824,Pre-Law Studies,1,Bachelor's degree,0,0,0,0,0,0,0,0,0,0,0,0,0,0,0,0,0,0,0,0,0,0,0,0,0,0,0,0,0,0
2021,194824,"Biology/Biological Sciences, General",1,Bachelor's degree,27,8,19,0,0,0,8,3,5,2,0,2,3,2,1,0,0,0,11,3,8,1,0,1,0,0,0,2,0,2
2021,194824,"Biology/Biological Sciences, General",1,Master's degree,8,2,6,0,0,0,1,1,0,1,0,1,1,0,1,0,0,0,5,1,4,0,0,0,0,0,0,0,0,0
2021,194824,Biochemistry and Molecular Biology,1,Bachelor's degree,0,0,0,0,0,0,0,0,0,0,0,0,0,0,0,0,0,0,0,0,0,0,0,0,0,0,0,0,0,0
2021,194824,Biochemistry and Molecular Biology,1,Master's degree,0,0,0,0,0,0,0,0,0,0,0,0,0,0,0,0,0,0,0,0,0,0,0,0,0,0,0,0,0,0
2021,194824,"Biochemistry, Biophysics and Molecular Biology, Other",1,Bachelor's degree,25,12,13,0,0,0,5,3,2,1,1,0,2,1,1,0,0,0,13,5,8,1,0,1,0,0,0,3,2,1
2021,194824,"Biochemistry, Biophysics and Molecular Biology, Other",1,Master's degree,4,2,2,0,0,0,0,0,0,0,0,0,2,1,1,0,0,0,2,1,1,0,0,0,0,0,0,0,0,0
2021,194824,Bioinformatics,1,Bachelor's degree,13,5,8,0,0,0,1,0,1,3,1,2,1,1,0,0,0,0,7,3,4,0,0,0,0,0,0,1,0,1
2021,194824,Neuroscience,1,Bachelor's degree,6,1,5,0,0,0,2,0,2,0,0,0,1,0,1,0,0,0,3,1,2,0,0,0,0,0,0,0,0,0
2021,194824,"Biological and Biomedical Sciences, Other",1,Bachelor's degree,0,0,0,0,0,0,0,0,0,0,0,0,0,0,0,0,0,0,0,0,0,0,0,0,0,0,0,0,0,0
2021,194824,"Mathematics, General",1,Bachelor's degree,69,33,36,0,0,0,6,3,3,2,0,2,4,3,1,0,0,0,21,8,13,3,0,3,0,0,0,33,19,14
2021,194824,"Mathematics, General",1,Master's degree,1,1,0,0,0,0,1,1,0,0,0,0,0,0,0,0,0,0,0,0,0,0,0,0,0,0,0,0,0,0
2021,194824,"Applied Mathematics, General",1,Master's degree,22,18,4,0,0,0,2,0,2,0,0,0,1,1,0,0,0,0,12,10,2,0,0,0,1,1,0,6,6,0
2021,194824,Financial Mathematics,1,Master's degree,29,17,12,0,0,0,2,1,1,0,0,0,0,0,0,0,0,0,6,5,1,2,1,1,0,0,0,19,10,9
2021,194824,"Multi-/Interdisciplinary Studies, General",1,Bachelor's degree,0,0,0,0,0,0,0,0,0,0,0,0,0,0,0,0,0,0,0,0,0,0,0,0,0,0,0,0,0,0
2021,194824,"Multi-/Interdisciplinary Studies, General",1,Master's degree,0,0,0,0,0,0,0,0,0,0,0,0,0,0,0,0,0,0,0,0,0,0,0,0,0,0,0,0,0,0
2021,194824,"Science, Technology and Society",1,Bachelor's degree,2,1,1,1,1,0,1,0,1,0,0,0,0,0,0,0,0,0,0,0,0,0,0,0,0,0,0,0,0,0
2021,194824,"Science, Technology and Society",1,Master's degree,3,2,1,0,0,0,0,0,0,0,0,0,0,0,0,0,0,0,3,2,1,0,0,0,0,0,0,0,0,0
2021,194824,Natural Sciences,1,Master's degree,0,0,0,0,0,0,0,0,0,0,0,0,0,0,0,0,0,0,0,0,0,0,0,0,0,0,0,0,0,0
2021,194824,"Cognitive Science, General",1,Bachelor's degree,5,2,3,0,0,0,0,0,0,0,0,0,1,1,0,0,0,0,2,1,1,1,0,1,0,0,0,1,0,1
2021,194824,"Cognitive Science, General",1,Master's degree,7,5,2,0,0,0,0,0,0,0,0,0,1,1,0,0,0,0,4,3,1,1,0,1,1,1,0,0,0,0
2021,194824,Human Computer Interaction,1,Master's degree,0,0,0,0,0,0,0,0,0,0,0,0,0,0,0,0,0,0,0,0,0,0,0,0,0,0,0,0,0,0
2021,194824,Sustainability Studies,1,Bachelor's degree,5,2,3,0,0,0,0,0,0,0,0,0,3,1,2,0,0,0,2,1,1,0,0,0,0,0,0,0,0,0
2021,194824,Business Analytics,1,Bachelor's degree,0,0,0,0,0,0,0,0,0,0,0,0,0,0,0,0,0,0,0,0,0,0,0,0,0,0,0,0,0,0
2021,194824,"Multi-/Interdisciplinary Studies, Other",1,Bachelor's degree,7,5,2,0,0,0,2,1,1,0,0,0,1,0,1,0,0,0,4,4,0,0,0,0,0,0,0,0,0,0
2021,194824,"Multi-/Interdisciplinary Studies, Other",1,Master's degree,0,0,0,0,0,0,0,0,0,0,0,0,0,0,0,0,0,0,0,0,0,0,0,0,0,0,0,0,0,0
2021,194824,Philosophy,1,Bachelor's degree,0,0,0,0,0,0,0,0,0,0,0,0,0,0,0,0,0,0,0,0,0,0,0,0,0,0,0,0,0,0
2021,194824,Philosophy,1,Master's degree,0,0,0,0,0,0,0,0,0,0,0,0,0,0,0,0,0,0,0,0,0,0,0,0,0,0,0,0,0,0
2021,194824,Astronomy,1,Master's degree,1,0,1,0,0,0,0,0,0,0,0,0,1,0,1,0,0,0,0,0,0,0,0,0,0,0,0,0,0,0
2021,194824,"Chemistry, General",1,Bachelor's degree,15,7,8,0,0,0,2,0,2,0,0,0,1,1,0,0,0,0,11,5,6,0,0,0,0,0,0,1,1,0
2021,194824,"Chemistry, General",1,Master's degree,7,4,3,0,0,0,0,0,0,1,0,1,2,1,1,0,0,0,4,3,1,0,0,0,0,0,0,0,0,0
2021,194824,"Geology/Earth Science, General",1,Bachelor's degree,4,2,2,0,0,0,0,0,0,0,0,0,0,0,0,0,0,0,1,0,1,2,1,1,0,0,0,1,1,0
2021,194824,"Geology/Earth Science, General",1,Master's degree,2,1,1,0,0,0,0,0,0,0,0,0,0,0,0,0,0,0,2,1,1,0,0,0,0,0,0,0,0,0
2021,194824,Hydrology and Water Resources Science,1,Bachelor's degree,0,0,0,0,0,0,0,0,0,0,0,0,0,0,0,0,0,0,0,0,0,0,0,0,0,0,0,0,0,0
2021,194824,Hydrology and Water Resources Science,1,Master's degree,0,0,0,0,0,0,0,0,0,0,0,0,0,0,0,0,0,0,0,0,0,0,0,0,0,0,0,0,0,0
2021,194824,"Physics, General",1,Bachelor's degree,40,33,7,0,0,0,2,2,0,0,0,0,3,2,1,0,0,0,26,22,4,0,0,0,0,0,0,9,7,2
2021,194824,"Physics, General",1,Master's degree,6,5,1,0,0,0,0,0,0,0,0,0,1,1,0,0,0,0,5,4,1,0,0,0,0,0,0,0,0,0
2021,194824,"Physics, Other",1,Bachelor's degree,14,9,5,0,0,0,2,2,0,0,0,0,2,2,0,0,0,0,9,4,5,0,0,0,0,0,0,1,1,0
2021,194824,"Physical Sciences, Other",1,Bachelor's degree,0,0,0,0,0,0,0,0,0,0,0,0,0,0,0,0,0,0,0,0,0,0,0,0,0,0,0,0,0,0
2021,194824,"Physical Sciences, Other",1,Master's degree,0,0,0,0,0,0,0,0,0,0,0,0,0,0,0,0,0,0,0,0,0,0,0,0,0,0,0,0,0,0
2021,194824,"Psychology, General",1,Bachelor's degree,9,6,3,0,0,0,0,0,0,1,1,0,2,2,0,0,0,0,4,1,3,1,1,0,0,0,0,1,1,0
2021,194824,"Psychology, General",1,Master's degree,0,0,0,0,0,0,0,0,0,0,0,0,0,0,0,0,0,0,0,0,0,0,0,0,0,0,0,0,0,0
2021,194824,"Social Sciences, General",1,Bachelor's degree,0,0,0,0,0,0,0,0,0,0,0,0,0,0,0,0,0,0,0,0,0,0,0,0,0,0,0,0,0,0
2021,194824,"Social Sciences, General",1,Master's degree,0,0,0,0,0,0,0,0,0,0,0,0,0,0,0,0,0,0,0,0,0,0,0,0,0,0,0,0,0,0
2021,194824,"Economics, General",1,Bachelor's degree,2,2,0,0,0,0,1,1,0,0,0,0,0,0,0,0,0,0,0,0,0,0,0,0,0,0,0,1,1,0
2021,194824,"Economics, General",1,Master's degree,5,5,0,0,0,0,0,0,0,0,0,0,0,0,0,0,0,0,1,1,0,0,0,0,0,0,0,4,4,0
2021,194824,"Economics, Other",1,Master's degree,0,0,0,0,0,0,0,0,0,0,0,0,0,0,0,0,0,0,0,0,0,0,0,0,0,0,0,0,0,0
2021,194824,"Social Sciences, Other",1,Master's degree,0,0,0,0,0,0,0,0,0,0,0,0,0,0,0,0,0,0,0,0,0,0,0,0,0,0,0,0,0,0
2021,194824,"Visual and Performing Arts, General",1,Bachelor's degree,4,1,3,0,0,0,1,1,0,0,0,0,0,0,0,0,0,0,1,0,1,1,0,1,0,0,0,1,0,1
2021,194824,"Visual and Performing Arts, General",1,Master's degree,0,0,0,0,0,0,0,0,0,0,0,0,0,0,0,0,0,0,0,0,0,0,0,0,0,0,0,0,0,0
2021,194824,Game and Interactive Media Design,1,Bachelor's degree,24,19,5,0,0,0,4,4,0,0,0,0,0,0,0,0,0,0,16,12,4,2,1,1,1,1,0,1,1,0
2021,194824,Game and Interactive Media Design,1,Master's degree,5,4,1,0,0,0,0,0,0,1,1,0,1,1,0,0,0,0,1,0,1,0,0,0,0,0,0,2,2,0
2021,194824,Music Theory and Composition,1,Bachelor's degree,0,0,0,0,0,0,0,0,0,0,0,0,0,0,0,0,0,0,0,0,0,0,0,0,0,0,0,0,0,0
2021,194824,Pre-Medicine/Pre-Medical Studies,1,Bachelor's degree,9,4,5,0,0,0,7,2,5,0,0,0,0,0,0,0,0,0,1,1,0,1,1,0,0,0,0,0,0,0
2021,194824,"Business Administration and Management, General",1,Bachelor's degree,61,40,21,0,0,0,7,2,5,5,4,1,7,5,2,0,0,0,33,25,8,3,1,2,1,1,0,5,2,3
2021,194824,"Business Administration and Management, General",1,Master's degree,27,18,9,0,0,0,0,0,0,2,1,1,5,4,1,0,0,0,16,11,5,1,1,0,0,0,0,3,1,2
2021,194824,"Logistics, Materials, and Supply Chain Management",1,Master's degree,0,0,0,0,0,0,0,0,0,0,0,0,0,0,0,0,0,0,0,0,0,0,0,0,0,0,0,0,0,0
2021,194824,Entrepreneurship/Entrepreneurial Studies,1,Master's degree,2,2,0,0,0,0,0,0,0,0,0,0,0,0,0,0,0,0,2,2,0,0,0,0,0,0,0,0,0,0
2021,194824,"Finance and Financial Management Services, Other",1,Master's degree,0,0,0,0,0,0,0,0,0,0,0,0,0,0,0,0,0,0,0,0,0,0,0,0,0,0,0,0,0,0
2021,194824,Business Statistics,1,Bachelor's degree,3,3,0,0,0,0,2,2,0,0,0,0,0,0,0,0,0,0,1,1,0,0,0,0,0,0,0,0,0,0
2021,194824,Business Statistics,1,Master's degree,73,31,42,0,0,0,3,2,1,1,1,0,4,3,1,0,0,0,14,8,6,1,1,0,0,0,0,50,16,34
2021,194824,"Management Sciences and Quantitative Methods, Other",1,Master's degree,12,5,7,0,0,0,3,1,2,0,0,0,0,0,0,0,0,0,4,2,2,0,0,0,1,0,1,4,2,2
2021,194824,"Business, Management, Marketing, and Related Support Services, Other",1,Master's degree,0,0,0,0,0,0,0,0,0,0,0,0,0,0,0,0,0,0,0,0,0,0,0,0,0,0,0,0,0,0
2021,194824,99,1,Bachelor's degree,1582,1090,492,3,3,0,246,153,93,61,42,19,139,105,34,0,0,0,772,526,246,75,47,28,25,18,7,261,196,65
2021,194824,99,1,Master's degree,486,317,169,0,0,0,35,24,11,9,6,3,37,28,9,1,0,1,190,131,59,15,10,5,8,6,2,191,112,79
2023,194824,Environmental Science,1,Bachelor's degree,6,4,2,0,0,0,0,0,0,0,0,0,1,0,1,0,0,0,3,2,1,0,0,0,0,0,0,2,2,0
2023,194824,Architecture,1,Bachelor's degree,56,24,32,0,0,0,10,5,5,5,1,4,8,4,4,0,0,0,23,11,12,4,1,3,0,0,0,6,2,4
2023,194824,Architecture,1,Master's degree,3,2,1,0,0,0,0,0,0,0,0,0,0,0,0,0,0,0,2,2,0,0,0,0,0,0,0,1,0,1
2023,194824,Architectural and Building Sciences/Technology,1,Bachelor's degree,1,0,1,0,0,0,0,0,0,1,0,1,0,0,0,0,0,0,0,0,0,0,0,0,0,0,0,0,0,0
2023,194824,Architectural and Building Sciences/Technology,1,Master's degree,6,4,2,0,0,0,0,0,0,0,0,0,1,1,0,0,0,0,3,1,2,0,0,0,0,0,0,2,2,0
2023,194824,"Communication, General",1,Bachelor's degree,3,0,3,0,0,0,0,0,0,0,0,0,0,0,0,0,0,0,3,0,3,0,0,0,0,0,0,0,0,0
2023,194824,Speech Communication and Rhetoric,1,Bachelor's degree,0,0,0,0,0,0,0,0,0,0,0,0,0,0,0,0,0,0,0,0,0,0,0,0,0,0,0,0,0,0
2023,194824,Speech Communication and Rhetoric,1,Master's degree,2,1,1,0,0,0,0,0,0,0,0,0,0,0,0,0,0,0,1,1,0,0,0,0,0,0,0,1,0,1
2023,194824,Digital Communication and Media/Multimedia,1,Bachelor's degree,2,1,1,0,0,0,0,0,0,0,0,0,0,0,0,0,0,0,1,1,0,0,0,0,0,0,0,1,0,1
2023,194824,Technical and Scientific Communication,1,Master's degree,0,0,0,0,0,0,0,0,0,0,0,0,0,0,0,0,0,0,0,0,0,0,0,0,0,0,0,0,0,0
2023,194824,"Computer and Information Sciences, General",1,Bachelor's degree,0,0,0,0,0,0,0,0,0,0,0,0,0,0,0,0,0,0,0,0,0,0,0,0,0,0,0,0,0,0
2023,194824,"Computer and Information Sciences, General",1,Master's degree,0,0,0,0,0,0,0,0,0,0,0,0,0,0,0,0,0,0,0,0,0,0,0,0,0,0,0,0,0,0
2023,194824,Information Technology,1,Bachelor's degree,35,22,13,0,0,0,9,4,5,0,0,0,2,2,0,0,0,0,14,9,5,0,0,0,2,1,1,8,6,2
2023,194824,Information Technology,1,Master's degree,18,12,6,0,0,0,6,3,3,0,0,0,1,0,1,0,0,0,3,3,0,1,1,0,0,0,0,7,5,2
2023,194824,Computer Science,1,Bachelor's degree,250,198,52,1,1,0,69,47,22,7,7,0,11,9,2,0,0,0,92,75,17,7,5,2,15,13,2,48,41,7
2023,194824,Computer Science,1,Master's degree,38,32,6,0,0,0,5,3,2,1,1,0,0,0,0,0,0,0,18,17,1,3,2,1,0,0,0,11,9,2
2023,194824,"Aerospace, Aeronautical, and Astronautical/Space Engineering, General",1,Bachelor's degree,117,83,34,0,0,0,14,11,3,5,2,3,10,6,4,0,0,0,61,48,13,8,3,5,9,4,5,10,9,1
2023,194824,"Aerospace, Aeronautical, and Astronautical/Space Engineering, General",1,Master's degree,23,15,8,0,0,0,2,1,1,1,1,0,4,2,2,0,0,0,13,9,4,2,1,1,0,0,0,1,1,0
2023,194824,Bioengineering and Biomedical Engineering,1,Bachelor's degree,65,24,41,0,0,0,16,5,11,4,3,1,6,1,5,0,0,0,32,13,19,2,1,1,2,1,1,3,0,3
2023,194824,Bioengineering and Biomedical Engineering,1,Master's degree,14,3,11,0,0,0,1,0,1,0,0,0,5,2,3,0,0,0,7,1,6,0,0,0,0,0,0,1,0,1
2023,194824,Chemical Engineering,1,Bachelor's degree,61,37,24,0,0,0,12,6,6,2,2,0,7,5,2,0,0,0,27,16,11,5,4,1,1,0,1,7,4,3
2023,194824,Chemical Engineering,1,Master's degree,7,4,3,0,0,0,1,1,0,0,0,0,1,1,0,0,0,0,5,2,3,0,0,0,0,0,0,0,0,0
2023,194824,"Civil Engineering, General",1,Bachelor's degree,53,34,19,0,0,0,5,2,3,3,3,0,1,0,1,0,0,0,40,25,15,2,2,0,0,0,0,2,2,0
2023,194824,"Civil Engineering, General",1,Master's degree,16,6,10,0,0,0,7,1,6,0,0,0,2,1,1,0,0,0,6,3,3,1,1,0,0,0,0,0,0,0
2023,194824,Transportation and Highway Engineering,1,Master's degree,1,1,0,0,0,0,0,0,0,0,0,0,0,0,0,0,0,0,1,1,0,0,0,0,0,0,0,0,0,0
2023,194824,Electrical and Electronics Engineering,1,Bachelor's degree,69,61,8,0,0,0,10,8,2,2,2,0,9,9,0,0,0,0,21,17,4,3,3,0,0,0,0,24,22,2
2023,194824,Electrical and Electronics Engineering,1,Master's degree,10,9,1,0,0,0,1,1,0,0,0,0,0,0,0,0,0,0,3,3,0,2,2,0,1,1,0,3,2,1
2023,194824,Engineering Physics/Applied Physics,1,Bachelor's degree,0,0,0,0,0,0,0,0,0,0,0,0,0,0,0,0,0,0,0,0,0,0,0,0,0,0,0,0,0,0
2023,194824,Engineering Physics/Applied Physics,1,Master's degree,0,0,0,0,0,0,0,0,0,0,0,0,0,0,0,0,0,0,0,0,0,0,0,0,0,0,0,0,0,0
2023,194824,Engineering Science,1,Bachelor's degree,0,0,0,0,0,0,0,0,0,0,0,0,0,0,0,0,0,0,0,0,0,0,0,0,0,0,0,0,0,0
2023,194824,Engineering Science,1,Master's degree,0,0,0,0,0,0,0,0,0,0,0,0,0,0,0,0,0,0,0,0,0,0,0,0,0,0,0,0,0,0
2023,194824,Environmental/Environmental Health Engineering,1,Bachelor's degree,14,4,10,0,0,0,1,1,0,0,0,0,1,0,1,0,0,0,11,3,8,0,0,0,1,0,1,0,0,0
2023,194824,Environmental/Environmental Health Engineering,1,Master's degree,4,2,2,0,0,0,0,0,0,0,0,0,0,0,0,0,0,0,4,2,2,0,0,0,0,0,0,0,0,0
2023,194824,Materials Engineering,1,Bachelor's degree,14,9,5,0,0,0,1,0,1,0,0,0,0,0,0,0,0,0,9,6,3,0,0,0,0,0,0,4,3,1
2023,194824,Materials Engineering,1,Master's degree,8,6,2,0,0,0,0,0,0,0,0,0,0,0,0,0,0,0,6,5,1,0,0,0,0,0,0,2,1,1
2023,194824,Mechanical Engineering,1,Bachelor's degree,162,120,42,0,0,0,26,19,7,5,4,1,17,12,5,0,0,0,86,59,27,8,6,2,3,3,0,17,17,0
2023,194824,Mechanical Engineering,1,Master's degree,21,15,6,0,0,0,4,2,2,2,1,1,3,1,2,0,0,0,7,6,1,2,2,0,0,0,0,3,3,0
2023,194824,Nuclear Engineering,1,Bachelor's degree,18,9,9,0,0,0,0,0,0,3,0,3,2,1,1,0,0,0,13,8,5,0,0,0,0,0,0,0,0,0
2023,194824,Nuclear Engineering,1,Master's degree,5,4,1,0,0,0,0,0,0,1,0,1,1,1,0,0,0,0,2,2,0,0,0,0,0,0,0,1,1,0
2023,194824,Systems Engineering,1,Master's degree,6,3,3,0,0,0,1,0,1,0,0,0,3,2,1,0,0,0,2,1,1,0,0,0,0,0,0,0,0,0
2023,194824,Industrial Engineering,1,Bachelor's degree,29,20,9,0,0,0,1,0,1,4,2,2,2,2,0,0,0,0,14,9,5,4,4,0,2,1,1,2,2,0
2023,194824,Industrial Engineering,1,Master's degree,0,0,0,0,0,0,0,0,0,0,0,0,0,0,0,0,0,0,0,0,0,0,0,0,0,0,0,0,0,0
2023,194824,Operations Research,1,Master's degree,0,0,0,0,0,0,0,0,0,0,0,0,0,0,0,0,0,0,0,0,0,0,0,0,0,0,0,0,0,0
2023,194824,Computer/Computer Systems Technology/Technician,1,Bachelor's degree,62,53,9,0,0,0,12,9,3,2,2,0,4,3,1,0,0,0,21,17,4,4,3,1,1,1,0,18,18,0
2023,194824,Computer/Computer Systems Technology/Technician,1,Master's degree,6,4,2,0,0,0,0,0,0,0,0,0,0,0,0,0,0,0,3,2,1,0,0,0,0,0,0,3,2,1
2023,194824,Pre-Law Studies,1,Bachelor's degree,0,0,0,0,0,0,0,0,0,0,0,0,0,0,0,0,0,0,0,0,0,0,0,0,0,0,0,0,0,0
2023,194824,"Biology/Biological Sciences, General",1,Bachelor's degree,28,8,20,0,0,0,7,0,7,1,0,1,1,1,0,0,0,0,13,4,9,0,0,0,1,1,0,5,2,3
2023,194824,"Biology/Biological Sciences, General",1,Master's degree,2,0,2,0,0,0,0,0,0,0,0,0,1,0,1,0,0,0,1,0,1,0,0,0,0,0,0,0,0,0
2023,194824,Biochemistry and Molecular Biology,1,Bachelor's degree,0,0,0,0,0,0,0,0,0,0,0,0,0,0,0,0,0,0,0,0,0,0,0,0,0,0,0,0,0,0
2023,194824,Biochemistry and Molecular Biology,1,Master's degree,0,0,0,0,0,0,0,0,0,0,0,0,0,0,0,0,0,0,0,0,0,0,0,0,0,0,0,0,0,0
2023,194824,"Biochemistry, Biophysics and Molecular Biology, Other",1,Bachelor's degree,20,6,14,0,0,0,3,0,3,1,0,1,1,1,0,0,0,0,12,4,8,1,0,1,1,0,1,1,1,0
2023,194824,"Biochemistry, Biophysics and Molecular Biology, Other",1,Master's degree,2,0,2,0,0,0,1,0,1,0,0,0,1,0,1,0,0,0,0,0,0,0,0,0,0,0,0,0,0,0
2023,194824,Bioinformatics,1,Bachelor's degree,7,3,4,0,0,0,3,0,3,0,0,0,1,1,0,0,0,0,3,2,1,0,0,0,0,0,0,0,0,0
2023,194824,Neuroscience,1,Bachelor's degree,3,1,2,0,0,0,1,0,1,0,0,0,0,0,0,0,0,0,1,0,1,0,0,0,0,0,0,1,1,0
2023,194824,"Mathematics, General",1,Bachelor's degree,75,49,26,0,0,0,10,8,2,3,1,2,4,3,1,0,0,0,12,7,5,1,1,0,3,1,2,42,28,14
2023,194824,"Mathematics, General",1,Master's degree,0,0,0,0,0,0,0,0,0,0,0,0,0,0,0,0,0,0,0,0,0,0,0,0,0,0,0,0,0,0
2023,194824,"Applied Mathematics, General",1,Master's degree,12,8,4,0,0,0,1,1,0,0,0,0,0,0,0,0,0,0,5,3,2,1,1,0,0,0,0,5,3,2
2023,194824,Financial Mathematics,1,Master's degree,16,15,1,0,0,0,4,4,0,1,1,0,0,0,0,0,0,0,5,5,0,2,2,0,0,0,0,4,3,1
2023,194824,"Multi-/Interdisciplinary Studies, General",1,Bachelor's degree,0,0,0,0,0,0,0,0,0,0,0,0,0,0,0,0,0,0,0,0,0,0,0,0,0,0,0,0,0,0
2023,194824,"Multi-/Interdisciplinary Studies, General",1,Master's degree,0,0,0,0,0,0,0,0,0,0,0,0,0,0,0,0,0,0,0,0,0,0,0,0,0,0,0,0,0,0
2023,194824,Biological and Physical Sciences,1,Master's degree,2,1,1,0,0,0,0,0,0,1,1,0,0,0,0,0,0,0,0,0,0,0,0,0,0,0,0,1,0,1
2023,194824,"Science, Technology and Society",1,Bachelor's degree,7,2,5,0,0,0,2,0,2,1,1,0,0,0,0,0,0,0,4,1,3,0,0,0,0,0,0,0,0,0
2023,194824,"Science, Technology and Society",1,Master's degree,3,2,1,0,0,0,0,0,0,0,0,0,2,1,1,0,0,0,1,1,0,0,0,0,0,0,0,0,0,0
2023,194824,Natural Sciences,1,Master's degree,0,0,0,0,0,0,0,0,0,0,0,0,0,0,0,0,0,0,0,0,0,0,0,0,0,0,0,0,0,0
2023,194824,"Cognitive Science, General",1,Bachelor's degree,7,3,4,0,0,0,1,0,1,0,0,0,2,0,2,0,0,0,3,2,1,0,0,0,0,0,0,1,1,0
2023,194824,"Cognitive Science, General",1,Master's degree,5,4,1,0,0,0,0,0,0,1,1,0,0,0,0,0,0,0,3,3,0,1,0,1,0,0,0,0,0,0
2023,194824,Human Computer Interaction,1,Master's degree,0,0,0,0,0,0,0,0,0,0,0,0,0,0,0,0,0,0,0,0,0,0,0,0,0,0,0,0,0,0
2023,194824,Sustainability Studies,1,Bachelor's degree,3,0,3,0,0,0,0,0,0,0,0,0,0,0,0,0,0,0,3,0,3,0,0,0,0,0,0,0,0,0
2023,194824,Business Analytics,1,Bachelor's degree,0,0,0,0,0,0,0,0,0,0,0,0,0,0,0,0,0,0,0,0,0,0,0,0,0,0,0,0,0,0
2023,194824,"Multi-/Interdisciplinary Studies, Other",1,Bachelor's degree,4,4,0,0,0,0,1,1,0,0,0,0,2,2,0,0,0,0,0,0,0,0,0,0,0,0,0,1,1,0
2023,194824,"Multi-/Interdisciplinary Studies, Other",1,Master's degree,0,0,0,0,0,0,0,0,0,0,0,0,0,0,0,0,0,0,0,0,0,0,0,0,0,0,0,0,0,0
2023,194824,Philosophy,1,Bachelor's degree,2,2,0,0,0,0,0,0,0,0,0,0,1,1,0,0,0,0,0,0,0,0,0,0,0,0,0,1,1,0
2023,194824,Philosophy,1,Master's degree,0,0,0,0,0,0,0,0,0,0,0,0,0,0,0,0,0,0,0,0,0,0,0,0,0,0,0,0,0,0
2023,194824,Astronomy,1,Master's degree,2,1,1,0,0,0,0,0,0,1,1,0,0,0,0,0,0,0,1,0,1,0,0,0,0,0,0,0,0,0
2023,194824,"Chemistry, General",1,Bachelor's degree,22,12,10,0,0,0,1,1,0,0,0,0,0,0,0,0,0,0,11,6,5,0,0,0,1,0,1,9,5,4
2023,194824,"Chemistry, General",1,Master's degree,1,0,1,0,0,0,1,0,1,0,0,0,0,0,0,0,0,0,0,0,0,0,0,0,0,0,0,0,0,0
2023,194824,"Geology/Earth Science, General",1,Bachelor's degree,2,0,2,0,0,0,0,0,0,0,0,0,1,0,1,0,0,0,1,0,1,0,0,0,0,0,0,0,0,0
2023,194824,"Geology/Earth Science, General",1,Master's degree,0,0,0,0,0,0,0,0,0,0,0,0,0,0,0,0,0,0,0,0,0,0,0,0,0,0,0,0,0,0
2023,194824,Hydrology and Water Resources Science,1,Bachelor's degree,0,0,0,0,0,0,0,0,0,0,0,0,0,0,0,0,0,0,0,0,0,0,0,0,0,0,0,0,0,0
2023,194824,Hydrology and Water Resources Science,1,Master's degree,0,0,0,0,0,0,0,0,0,0,0,0,0,0,0,0,0,0,0,0,0,0,0,0,0,0,0,0,0,0
2023,194824,"Physics, General",1,Bachelor's degree,35,29,6,0,0,0,2,2,0,2,1,1,4,4,0,0,0,0,21,18,3,2,1,1,0,0,0,4,3,1
2023,194824,"Physics, General",1,Master's degree,6,5,1,0,0,0,0,0,0,0,0,0,0,0,0,0,0,0,3,3,0,0,0,0,0,0,0,3,2,1
2023,194824,"Physics, Other",1,Bachelor's degree,7,3,4,0,0,0,1,1,0,0,0,0,1,0,1,0,0,0,4,2,2,0,0,0,0,0,0,1,0,1
2023,194824,"Psychology, General",1,Bachelor's degree,13,1,12,0,0,0,3,0,3,2,1,1,1,0,1,0,0,0,5,0,5,1,0,1,0,0,0,1,0,1
2023,194824,"Psychology, General",1,Master's degree,0,0,0,0,0,0,0,0,0,0,0,0,0,0,0,0,0,0,0,0,0,0,0,0,0,0,0,0,0,0
2023,194824,"Social Sciences, General",1,Bachelor's degree,0,0,0,0,0,0,0,0,0,0,0,0,0,0,0,0,0,0,0,0,0,0,0,0,0,0,0,0,0,0
2023,194824,"Social Sciences, General",1,Master's degree,0,0,0,0,0,0,0,0,0,0,0,0,0,0,0,0,0,0,0,0,0,0,0,0,0,0,0,0,0,0
2023,194824,"Economics, General",1,Bachelor's degree,0,0,0,0,0,0,0,0,0,0,0,0,0,0,0,0,0,0,0,0,0,0,0,0,0,0,0,0,0,0
2023,194824,"Economics, General",1,Master's degree,0,0,0,0,0,0,0,0,0,0,0,0,0,0,0,0,0,0,0,0,0,0,0,0,0,0,0,0,0,0
2023,194824,Econometrics and Quantitative Economics,1,Bachelor's degree,8,7,1,0,0,0,0,0,0,0,0,0,1,1,0,0,0,0,3,2,1,0,0,0,0,0,0,4,4,0
2023,194824,Econometrics and Quantitative Economics,1,Master's degree,2,2,0,0,0,0,0,0,0,0,0,0,1,1,0,0,0,0,1,1,0,0,0,0,0,0,0,0,0,0
2023,194824,"Economics, Other",1,Master's degree,0,0,0,0,0,0,0,0,0,0,0,0,0,0,0,0,0,0,0,0,0,0,0,0,0,0,0,0,0,0
2023,194824,"Social Sciences, Other",1,Master's degree,0,0,0,0,0,0,0,0,0,0,0,0,0,0,0,0,0,0,0,0,0,0,0,0,0,0,0,0,0,0
2023,194824,"Visual and Performing Arts, General",1,Bachelor's degree,4,1,3,0,0,0,0,0,0,0,0,0,1,0,1,0,0,0,2,1,1,1,0,1,0,0,0,0,0,0
2023,194824,"Visual and Performing Arts, General",1,Master's degree,0,0,0,0,0,0,0,0,0,0,0,0,0,0,0,0,0,0,0,0,0,0,0,0,0,0,0,0,0,0
2023,194824,Game and Interactive Media Design,1,Bachelor's degree,34,24,10,0,0,0,5,3,2,1,0,1,5,3,2,0,0,0,12,10,2,3,1,2,1,1,0,7,6,1
2023,194824,Game and Interactive Media Design,1,Master's degree,6,6,0,0,0,0,1,1,0,1,1,0,0,0,0,0,0,0,3,3,0,0,0,0,0,0,0,1,1,0
2023,194824,Music Theory and Composition,1,Bachelor's degree,1,0,1,0,0,0,0,0,0,1,0,1,0,0,0,0,0,0,0,0,0,0,0,0,0,0,0,0,0,0
2023,194824,Pre-Medicine/Pre-Medical Studies,1,Bachelor's degree,15,8,7,0,0,0,12,5,7,0,0,0,0,0,0,0,0,0,1,1,0,0,0,0,2,2,0,0,0,0
2023,194824,"Business Administration and Management, General",1,Bachelor's degree,58,43,15,0,0,0,5,1,4,5,3,2,6,5,1,0,0,0,29,23,6,7,6,1,3,2,1,3,3,0
2023,194824,"Business Administration and Management, General",1,Master's degree,0,0,0,0,0,0,0,0,0,0,0,0,0,0,0,0,0,0,0,0,0,0,0,0,0,0,0,0,0,0
2023,194824,"Logistics, Materials, and Supply Chain Management",1,Master's degree,0,0,0,0,0,0,0,0,0,0,0,0,0,0,0,0,0,0,0,0,0,0,0,0,0,0,0,0,0,0
2023,194824,Entrepreneurship/Entrepreneurial Studies,1,Master's degree,0,0,0,0,0,0,0,0,0,0,0,0,0,0,0,0,0,0,0,0,0,0,0,0,0,0,0,0,0,0
2023,194824,"Finance and Financial Management Services, Other",1,Master's degree,0,0,0,0,0,0,0,0,0,0,0,0,0,0,0,0,0,0,0,0,0,0,0,0,0,0,0,0,0,0
2023,194824,Business Statistics,1,Bachelor's degree,7,5,2,1,0,1,1,1,0,0,0,0,0,0,0,0,0,0,1,1,0,0,0,0,0,0,0,4,3,1
2023,194824,Business Statistics,1,Master's degree,48,28,20,0,0,0,6,4,2,1,1,0,3,1,2,0,0,0,11,8,3,2,2,0,1,0,1,24,12,12
2023,194824,"Management Sciences and Quantitative Methods, Other",1,Master's degree,52,36,16,0,0,0,4,2,2,5,3,2,8,4,4,0,0,0,26,21,5,4,3,1,0,0,0,5,3,2
2023,194824,99,1,Bachelor's degree,1379,914,465,2,1,1,244,140,104,60,35,25,113,76,37,0,0,0,612,403,209,63,41,22,48,31,17,237,187,50
2023,194824,99,1,Master's degree,347,231,116,0,0,0,46,24,22,16,12,4,37,18,19,0,0,0,146,109,37,21,17,4,2,1,1,79,50,29
2022,194824,Environmental Science,1,Bachelor's degree,0,0,0,0,0,0,0,0,0,0,0,0,0,0,0,0,0,0,0,0,0,0,0,0,0,0,0,0,0,0
2022,194824,Architecture,1,Bachelor's degree,57,21,36,0,0,0,5,1,4,6,4,2,3,1,2,0,0,0,29,12,17,5,2,3,3,0,3,6,1,5
2022,194824,Architecture,1,Master's degree,5,4,1,0,0,0,0,0,0,1,1,0,1,1,0,0,0,0,0,0,0,1,1,0,0,0,0,2,1,1
2022,194824,Architectural and Building Sciences/Technology,1,Bachelor's degree,0,0,0,0,0,0,0,0,0,0,0,0,0,0,0,0,0,0,0,0,0,0,0,0,0,0,0,0,0,0
2022,194824,Architectural and Building Sciences/Technology,1,Master's degree,8,4,4,0,0,0,0,0,0,0,0,0,2,0,2,0,0,0,3,2,1,0,0,0,0,0,0,3,2,1
2022,194824,"Communication, General",1,Bachelor's degree,3,1,2,0,0,0,0,0,0,2,1,1,0,0,0,0,0,0,1,0,1,0,0,0,0,0,0,0,0,0
2022,194824,Speech Communication and Rhetoric,1,Bachelor's degree,0,0,0,0,0,0,0,0,0,0,0,0,0,0,0,0,0,0,0,0,0,0,0,0,0,0,0,0,0,0
2022,194824,Speech Communication and Rhetoric,1,Master's degree,1,1,0,0,0,0,0,0,0,0,0,0,0,0,0,0,0,0,1,1,0,0,0,0,0,0,0,0,0,0
2022,194824,Digital Communication and Media/Multimedia,1,Bachelor's degree,8,3,5,0,0,0,2,0,2,0,0,0,2,2,0,0,0,0,4,1,3,0,0,0,0,0,0,0,0,0
2022,194824,Technical and Scientific Communication,1,Master's degree,0,0,0,0,0,0,0,0,0,0,0,0,0,0,0,0,0,0,0,0,0,0,0,0,0,0,0,0,0,0
2022,194824,"Computer and Information Sciences, General",1,Bachelor's degree,0,0,0,0,0,0,0,0,0,0,0,0,0,0,0,0,0,0,0,0,0,0,0,0,0,0,0,0,0,0
2022,194824,"Computer and Information Sciences, General",1,Master's degree,0,0,0,0,0,0,0,0,0,0,0,0,0,0,0,0,0,0,0,0,0,0,0,0,0,0,0,0,0,0
2022,194824,Information Technology,1,Bachelor's degree,46,33,13,0,0,0,8,3,5,1,1,0,5,4,1,0,0,0,23,16,7,1,1,0,2,2,0,6,6,0
2022,194824,Information Technology,1,Master's degree,28,23,5,0,0,0,3,2,1,1,1,0,1,1,0,0,0,0,5,5,0,0,0,0,0,0,0,18,14,4
2022,194824,Computer Science,1,Bachelor's degree,284,228,56,1,1,0,80,54,26,7,5,2,17,15,2,0,0,0,123,104,19,11,10,1,5,4,1,40,35,5
2022,194824,Computer Science,1,Master's degree,26,23,3,0,0,0,4,4,0,0,0,0,2,2,0,0,0,0,11,10,1,0,0,0,1,1,0,8,6,2
2022,194824,"Aerospace, Aeronautical, and Astronautical/Space Engineering, General",1,Bachelor's degree,112,91,21,0,0,0,12,11,1,2,2,0,13,9,4,0,0,0,65,51,14,8,7,1,1,0,1,11,11,0
2022,194824,"Aerospace, Aeronautical, and Astronautical/Space Engineering, General",1,Master's degree,27,26,1,0,0,0,0,0,0,1,0,1,3,3,0,0,0,0,21,21,0,1,1,0,0,0,0,1,1,0
2022,194824,Bioengineering and Biomedical Engineering,1,Bachelor's degree,70,23,47,1,1,0,10,3,7,4,1,3,12,3,9,0,0,0,39,13,26,1,0,1,2,1,1,1,1,0
2022,194824,Bioengineering and Biomedical Engineering,1,Master's degree,21,12,9,0,0,0,2,1,1,2,2,0,1,1,0,0,0,0,13,7,6,3,1,2,0,0,0,0,0,0
2022,194824,Chemical Engineering,1,Bachelor's degree,63,37,26,0,0,0,6,2,4,3,2,1,5,3,2,0,0,0,42,28,14,3,1,2,0,0,0,4,1,3
2022,194824,Chemical Engineering,1,Master's degree,12,6,6,0,0,0,0,0,0,2,1,1,0,0,0,0,0,0,7,3,4,0,0,0,0,0,0,3,2,1
2022,194824,"Civil Engineering, General",1,Bachelor's degree,52,27,25,0,0,0,13,2,11,2,2,0,8,3,5,0,0,0,24,16,8,1,1,0,2,1,1,2,2,0
2022,194824,"Civil Engineering, General",1,Master's degree,21,13,8,0,0,0,3,1,2,0,0,0,1,1,0,0,0,0,13,8,5,1,1,0,2,1,1,1,1,0
2022,194824,Transportation and Highway Engineering,1,Master's degree,2,1,1,0,0,0,0,0,0,0,0,0,0,0,0,0,0,0,1,1,0,1,0,1,0,0,0,0,0,0
2022,194824,Electrical and Electronics Engineering,1,Bachelor's degree,107,85,22,0,0,0,19,13,6,1,1,0,5,4,1,0,0,0,39,27,12,5,3,2,4,4,0,34,33,1
2022,194824,Electrical and Electronics Engineering,1,Master's degree,19,13,6,0,0,0,3,2,1,0,0,0,1,1,0,0,0,0,5,3,2,0,0,0,0,0,0,10,7,3
2022,194824,Engineering Physics/Applied Physics,1,Bachelor's degree,0,0,0,0,0,0,0,0,0,0,0,0,0,0,0,0,0,0,0,0,0,0,0,0,0,0,0,0,0,0
2022,194824,Engineering Physics/Applied Physics,1,Master's degree,0,0,0,0,0,0,0,0,0,0,0,0,0,0,0,0,0,0,0,0,0,0,0,0,0,0,0,0,0,0
2022,194824,Engineering Science,1,Bachelor's degree,0,0,0,0,0,0,0,0,0,0,0,0,0,0,0,0,0,0,0,0,0,0,0,0,0,0,0,0,0,0
2022,194824,Engineering Science,1,Master's degree,0,0,0,0,0,0,0,0,0,0,0,0,0,0,0,0,0,0,0,0,0,0,0,0,0,0,0,0,0,0
2022,194824,Environmental/Environmental Health Engineering,1,Bachelor's degree,11,3,8,0,0,0,1,0,1,0,0,0,2,1,1,0,0,0,7,1,6,0,0,0,0,0,0,1,1,0
2022,194824,Environmental/Environmental Health Engineering,1,Master's degree,0,0,0,0,0,0,0,0,0,0,0,0,0,0,0,0,0,0,0,0,0,0,0,0,0,0,0,0,0,0
2022,194824,Materials Engineering,1,Bachelor's degree,12,8,4,0,0,0,0,0,0,1,1,0,1,1,0,0,0,0,8,4,4,0,0,0,0,0,0,2,2,0
2022,194824,Materials Engineering,1,Master's degree,9,8,1,0,0,0,0,0,0,0,0,0,2,1,1,0,0,0,4,4,0,2,2,0,0,0,0,1,1,0
2022,194824,Mechanical Engineering,1,Bachelor's degree,212,157,55,0,0,0,44,30,14,11,7,4,24,19,5,0,0,0,95,71,24,10,8,2,3,3,0,25,19,6
2022,194824,Mechanical Engineering,1,Master's degree,39,30,9,0,0,0,2,1,1,0,0,0,4,3,1,0,0,0,23,16,7,3,3,0,2,2,0,5,5,0
2022,194824,Nuclear Engineering,1,Bachelor's degree,14,9,5,0,0,0,1,0,1,1,1,0,3,2,1,0,0,0,8,5,3,1,1,0,0,0,0,0,0,0
2022,194824,Nuclear Engineering,1,Master's degree,1,1,0,0,0,0,0,0,0,0,0,0,0,0,0,0,0,0,1,1,0,0,0,0,0,0,0,0,0,0
2022,194824,Systems Engineering,1,Master's degree,4,3,1,0,0,0,0,0,0,0,0,0,1,0,1,0,0,0,3,3,0,0,0,0,0,0,0,0,0,0
2022,194824,Industrial Engineering,1,Bachelor's degree,56,34,22,0,0,0,12,8,4,3,1,2,7,5,2,0,0,0,27,16,11,1,0,1,2,1,1,4,3,1
2022,194824,Industrial Engineering,1,Master's degree,1,0,1,0,0,0,0,0,0,0,0,0,0,0,0,0,0,0,0,0,0,0,0,0,0,0,0,1,0,1
2022,194824,Operations Research,1,Master's degree,0,0,0,0,0,0,0,0,0,0,0,0,0,0,0,0,0,0,0,0,0,0,0,0,0,0,0,0,0,0
2022,194824,Computer/Computer Systems Technology/Technician,1,Bachelor's degree,80,64,16,0,0,0,20,17,3,0,0,0,10,6,4,0,0,0,28,23,5,7,7,0,1,1,0,14,10,4
2022,194824,Computer/Computer Systems Technology/Technician,1,Master's degree,8,7,1,0,0,0,0,0,0,0,0,0,0,0,0,0,0,0,5,5,0,0,0,0,0,0,0,3,2,1
2022,194824,Pre-Law Studies,1,Bachelor's degree,0,0,0,0,0,0,0,0,0,0,0,0,0,0,0,0,0,0,0,0,0,0,0,0,0,0,0,0,0,0
2022,194824,"Biology/Biological Sciences, General",1,Bachelor's degree,21,10,11,0,0,0,5,0,5,0,0,0,1,1,0,0,0,0,11,7,4,2,1,1,0,0,0,2,1,1
2022,194824,"Biology/Biological Sciences, General",1,Master's degree,2,1,1,0,0,0,0,0,0,0,0,0,0,0,0,0,0,0,2,1,1,0,0,0,0,0,0,0,0,0
2022,194824,Biochemistry and Molecular Biology,1,Bachelor's degree,0,0,0,0,0,0,0,0,0,0,0,0,0,0,0,0,0,0,0,0,0,0,0,0,0,0,0,0,0,0
2022,194824,Biochemistry and Molecular Biology,1,Master's degree,0,0,0,0,0,0,0,0,0,0,0,0,0,0,0,0,0,0,0,0,0,0,0,0,0,0,0,0,0,0
2022,194824,"Biochemistry, Biophysics and Molecular Biology, Other",1,Bachelor's degree,26,9,17,0,0,0,2,0,2,0,0,0,5,2,3,0,0,0,16,5,11,0,0,0,0,0,0,3,2,1
2022,194824,"Biochemistry, Biophysics and Molecular Biology, Other",1,Master's degree,4,0,4,0,0,0,0,0,0,0,0,0,0,0,0,0,0,0,4,0,4,0,0,0,0,0,0,0,0,0
2022,194824,Bioinformatics,1,Bachelor's degree,11,5,6,0,0,0,2,0,2,0,0,0,0,0,0,0,0,0,6,4,2,0,0,0,2,1,1,1,0,1
2022,194824,Neuroscience,1,Bachelor's degree,5,1,4,0,0,0,1,0,1,0,0,0,1,0,1,0,0,0,2,1,1,0,0,0,0,0,0,1,0,1
2022,194824,"Mathematics, General",1,Bachelor's degree,83,54,29,0,0,0,4,3,1,1,0,1,2,1,1,0,0,0,26,16,10,6,5,1,2,1,1,42,28,14
2022,194824,"Mathematics, General",1,Master's degree,0,0,0,0,0,0,0,0,0,0,0,0,0,0,0,0,0,0,0,0,0,0,0,0,0,0,0,0,0,0
2022,194824,"Applied Mathematics, General",1,Master's degree,16,7,9,0,0,0,2,2,0,0,0,0,0,0,0,0,0,0,9,2,7,0,0,0,0,0,0,5,3,2
2022,194824,Financial Mathematics,1,Master's degree,20,15,5,0,0,0,3,3,0,0,0,0,0,0,0,0,0,0,9,6,3,1,0,1,0,0,0,7,6,1
2022,194824,"Multi-/Interdisciplinary Studies, General",1,Bachelor's degree,0,0,0,0,0,0,0,0,0,0,0,0,0,0,0,0,0,0,0,0,0,0,0,0,0,0,0,0,0,0
2022,194824,"Multi-/Interdisciplinary Studies, General",1,Master's degree,1,0,1,0,0,0,0,0,0,0,0,0,1,0,1,0,0,0,0,0,0,0,0,0,0,0,0,0,0,0
2022,194824,"Science, Technology and Society",1,Bachelor's degree,3,1,2,0,0,0,1,0,1,0,0,0,2,1,1,0,0,0,0,0,0,0,0,0,0,0,0,0,0,0
2022,194824,"Science, Technology and Society",1,Master's degree,0,0,0,0,0,0,0,0,0,0,0,0,0,0,0,0,0,0,0,0,0,0,0,0,0,0,0,0,0,0
2022,194824,Natural Sciences,1,Master's degree,0,0,0,0,0,0,0,0,0,0,0,0,0,0,0,0,0,0,0,0,0,0,0,0,0,0,0,0,0,0
2022,194824,"Cognitive Science, General",1,Bachelor's degree,4,2,2,0,0,0,0,0,0,0,0,0,1,0,1,0,0,0,2,1,1,1,1,0,0,0,0,0,0,0
2022,194824,"Cognitive Science, General",1,Master's degree,2,1,1,0,0,0,1,0,1,0,0,0,0,0,0,0,0,0,0,0,0,0,0,0,0,0,0,1,1,0
2022,194824,Human Computer Interaction,1,Master's degree,0,0,0,0,0,0,0,0,0,0,0,0,0,0,0,0,0,0,0,0,0,0,0,0,0,0,0,0,0,0
2022,194824,Sustainability Studies,1,Bachelor's degree,2,1,1,0,0,0,0,0,0,1,1,0,0,0,0,0,0,0,1,0,1,0,0,0,0,0,0,0,0,0
2022,194824,Business Analytics,1,Bachelor's degree,0,0,0,0,0,0,0,0,0,0,0,0,0,0,0,0,0,0,0,0,0,0,0,0,0,0,0,0,0,0
2022,194824,"Multi-/Interdisciplinary Studies, Other",1,Bachelor's degree,17,2,15,0,0,0,3,1,2,0,0,0,1,0,1,0,0,0,11,1,10,2,0,2,0,0,0,0,0,0
2022,194824,"Multi-/Interdisciplinary Studies, Other",1,Master's degree,0,0,0,0,0,0,0,0,0,0,0,0,0,0,0,0,0,0,0,0,0,0,0,0,0,0,0,0,0,0
2022,194824,Philosophy,1,Bachelor's degree,2,2,0,0,0,0,0,0,0,0,0,0,0,0,0,0,0,0,1,1,0,0,0,0,0,0,0,1,1,0
2022,194824,Philosophy,1,Master's degree,0,0,0,0,0,0,0,0,0,0,0,0,0,0,0,0,0,0,0,0,0,0,0,0,0,0,0,0,0,0
2022,194824,Astronomy,1,Master's degree,1,1,0,0,0,0,0,0,0,0,0,0,0,0,0,0,0,0,0,0,0,1,1,0,0,0,0,0,0,0
2022,194824,"Chemistry, General",1,Bachelor's degree,10,5,5,0,0,0,2,1,1,0,0,0,0,0,0,0,0,0,4,2,2,1,0,1,0,0,0,3,2,1
2022,194824,"Chemistry, General",1,Master's degree,2,1,1,0,0,0,0,0,0,0,0,0,0,0,0,0,0,0,2,1,1,0,0,0,0,0,0,0,0,0
2022,194824,"Geology/Earth Science, General",1,Bachelor's degree,4,3,1,0,0,0,0,0,0,0,0,0,0,0,0,0,0,0,4,3,1,0,0,0,0,0,0,0,0,0
2022,194824,"Geology/Earth Science, General",1,Master's degree,1,0,1,0,0,0,0,0,0,0,0,0,0,0,0,0,0,0,1,0,1,0,0,0,0,0,0,0,0,0
2022,194824,Hydrology and Water Resources Science,1,Bachelor's degree,0,0,0,0,0,0,0,0,0,0,0,0,0,0,0,0,0,0,0,0,0,0,0,0,0,0,0,0,0,0
2022,194824,Hydrology and Water Resources Science,1,Master's degree,0,0,0,0,0,0,0,0,0,0,0,0,0,0,0,0,0,0,0,0,0,0,0,0,0,0,0,0,0,0
2022,194824,"Physics, General",1,Bachelor's degree,41,39,2,0,0,0,1,1,0,0,0,0,6,5,1,0,0,0,21,20,1,2,2,0,2,2,0,9,9,0
2022,194824,"Physics, General",1,Master's degree,5,5,0,0,0,0,0,0,0,0,0,0,0,0,0,0,0,0,2,2,0,0,0,0,0,0,0,3,3,0
2022,194824,"Physics, Other",1,Bachelor's degree,9,5,4,0,0,0,1,1,0,0,0,0,1,1,0,0,0,0,5,3,2,1,0,1,0,0,0,1,0,1
2022,194824,"Psychology, General",1,Bachelor's degree,6,1,5,0,0,0,0,0,0,1,1,0,2,0,2,0,0,0,3,0,3,0,0,0,0,0,0,0,0,0
2022,194824,"Psychology, General",1,Master's degree,0,0,0,0,0,0,0,0,0,0,0,0,0,0,0,0,0,0,0,0,0,0,0,0,0,0,0,0,0,0
2022,194824,"Social Sciences, General",1,Bachelor's degree,0,0,0,0,0,0,0,0,0,0,0,0,0,0,0,0,0,0,0,0,0,0,0,0,0,0,0,0,0,0
2022,194824,"Social Sciences, General",1,Master's degree,5,2,3,0,0,0,1,0,1,0,0,0,1,1,0,0,0,0,1,0,1,1,0,1,0,0,0,1,1,0
2022,194824,"Economics, General",1,Bachelor's degree,6,5,1,0,0,0,2,1,1,1,1,0,1,1,0,0,0,0,1,1,0,1,1,0,0,0,0,0,0,0
2022,194824,"Economics, General",1,Master's degree,3,1,2,0,0,0,0,0,0,0,0,0,0,0,0,0,0,0,2,1,1,0,0,0,0,0,0,1,0,1
2022,194824,"Economics, Other",1,Master's degree,0,0,0,0,0,0,0,0,0,0,0,0,0,0,0,0,0,0,0,0,0,0,0,0,0,0,0,0,0,0
2022,194824,"Social Sciences, Other",1,Master's degree,0,0,0,0,0,0,0,0,0,0,0,0,0,0,0,0,0,0,0,0,0,0,0,0,0,0,0,0,0,0
2022,194824,"Visual and Performing Arts, General",1,Bachelor's degree,5,0,5,0,0,0,0,0,0,1,0,1,1,0,1,0,0,0,0,0,0,2,0,2,1,0,1,0,0,0
2022,194824,"Visual and Performing Arts, General",1,Master's degree,0,0,0,0,0,0,0,0,0,0,0,0,0,0,0,0,0,0,0,0,0,0,0,0,0,0,0,0,0,0
2022,194824,Game and Interactive Media Design,1,Bachelor's degree,41,32,9,0,0,0,4,3,1,4,3,1,3,2,1,0,0,0,25,20,5,3,2,1,0,0,0,2,2,0
2022,194824,Game and Interactive Media Design,1,Master's degree,6,5,1,0,0,0,2,1,1,0,0,0,0,0,0,0,0,0,1,1,0,0,0,0,0,0,0,3,3,0
2022,194824,Music Theory and Composition,1,Bachelor's degree,4,2,2,0,0,0,0,0,0,0,0,0,2,1,1,0,0,0,2,1,1,0,0,0,0,0,0,0,0,0
2022,194824,Pre-Medicine/Pre-Medical Studies,1,Bachelor's degree,11,4,7,0,0,0,9,4,5,0,0,0,0,0,0,0,0,0,1,0,1,0,0,0,1,0,1,0,0,0
2022,194824,"Business Administration and Management, General",1,Bachelor's degree,56,39,17,0,0,0,5,2,3,1,1,0,4,3,1,0,0,0,32,24,8,3,2,1,2,1,1,9,6,3
2022,194824,"Business Administration and Management, General",1,Master's degree,24,12,12,0,0,0,3,1,2,0,0,0,5,1,4,0,0,0,15,10,5,0,0,0,0,0,0,1,0,1
2022,194824,"Logistics, Materials, and Supply Chain Management",1,Master's degree,0,0,0,0,0,0,0,0,0,0,0,0,0,0,0,0,0,0,0,0,0,0,0,0,0,0,0,0,0,0
2022,194824,Entrepreneurship/Entrepreneurial Studies,1,Master's degree,1,0,1,0,0,0,0,0,0,0,0,0,0,0,0,0,0,0,1,0,1,0,0,0,0,0,0,0,0,0
2022,194824,"Finance and Financial Management Services, Other",1,Master's degree,0,0,0,0,0,0,0,0,0,0,0,0,0,0,0,0,0,0,0,0,0,0,0,0,0,0,0,0,0,0
2022,194824,Business Statistics,1,Bachelor's degree,12,11,1,0,0,0,2,2,0,0,0,0,1,1,0,0,0,0,5,5,0,0,0,0,1,1,0,3,2,1
2022,194824,Business Statistics,1,Master's degree,36,16,20,0,0,0,5,2,3,4,3,1,2,0,2,0,0,0,10,6,4,2,1,1,0,0,0,13,4,9
2022,194824,"Management Sciences and Quantitative Methods, Other",1,Master's degree,10,8,2,0,0,0,1,0,1,0,0,0,1,1,0,0,0,0,3,3,0,0,0,0,0,0,0,5,4,1
2022,194824,99,1,Bachelor's degree,1566,1057,509,2,2,0,277,163,114,54,36,18,151,97,54,0,0,0,741,503,238,78,55,23,36,23,13,227,178,49
2022,194824,99,1,Master's degree,371,250,121,0,0,0,35,20,15,11,8,3,29,17,12,0,0,0,178,123,55,17,11,6,5,4,1,96,67,29
2019,194824,Environmental Science,1,Bachelor's degree,3,0,3,0,0,0,1,0,1,1,0,1,0,0,0,0,0,0,1,0,1,0,0,0,0,0,0,0,0,0
2019,194824,Architecture,1,Bachelor's degree,58,27,31,0,0,0,3,1,2,2,1,1,8,4,4,0,0,0,30,13,17,4,2,2,0,0,0,11,6,5
2019,194824,Architecture,1,Master's degree,0,0,0,0,0,0,0,0,0,0,0,0,0,0,0,0,0,0,0,0,0,0,0,0,0,0,0,0,0,0
2019,194824,Architectural and Building Sciences/Technology,1,Bachelor's degree,3,2,1,0,0,0,0,0,0,0,0,0,0,0,0,0,0,0,2,1,1,0,0,0,0,0,0,1,1,0
2019,194824,Architectural and Building Sciences/Technology,1,Master's degree,23,12,11,0,0,0,3,2,1,0,0,0,0,0,0,0,0,0,10,7,3,1,0,1,1,1,0,8,2,6
2019,194824,"Architecture and Related Services, Other",1,Bachelor's degree,0,0,0,0,0,0,0,0,0,0,0,0,0,0,0,0,0,0,0,0,0,0,0,0,0,0,0,0,0,0
2019,194824,"Architecture and Related Services, Other",1,Master's degree,6,4,2,0,0,0,0,0,0,0,0,0,0,0,0,0,0,0,3,1,2,0,0,0,1,1,0,2,2,0
2019,194824,"Communication, General",1,Bachelor's degree,1,1,0,0,0,0,0,0,0,0,0,0,0,0,0,0,0,0,0,0,0,1,1,0,0,0,0,0,0,0
2019,194824,Speech Communication and Rhetoric,1,Bachelor's degree,0,0,0,0,0,0,0,0,0,0,0,0,0,0,0,0,0,0,0,0,0,0,0,0,0,0,0,0,0,0
2019,194824,Speech Communication and Rhetoric,1,Master's degree,2,0,2,0,0,0,0,0,0,0,0,0,0,0,0,0,0,0,2,0,2,0,0,0,0,0,0,0,0,0
2019,194824,Digital Communication and Media/Multimedia,1,Bachelor's degree,13,5,8,0,0,0,1,1,0,0,0,0,1,0,1,0,0,0,6,3,3,2,0,2,0,0,0,3,1,2
2019,194824,Technical and Scientific Communication,1,Master's degree,0,0,0,0,0,0,0,0,0,0,0,0,0,0,0,0,0,0,0,0,0,0,0,0,0,0,0,0,0,0
2019,194824,"Computer and Information Sciences, General",1,Bachelor's degree,0,0,0,0,0,0,0,0,0,0,0,0,0,0,0,0,0,0,0,0,0,0,0,0,0,0,0,0,0,0
2019,194824,"Computer and Information Sciences, General",1,Master's degree,0,0,0,0,0,0,0,0,0,0,0,0,0,0,0,0,0,0,0,0,0,0,0,0,0,0,0,0,0,0
2019,194824,Information Technology,1,Bachelor's degree,15,10,5,0,0,0,1,1,0,0,0,0,1,1,0,0,0,0,10,8,2,1,0,1,1,0,1,1,0,1
2019,194824,Information Technology,1,Master's degree,29,18,11,0,0,0,2,2,0,1,1,0,0,0,0,0,0,0,2,1,1,2,2,0,1,1,0,21,11,10
2019,194824,Computer Science,1,Bachelor's degree,197,161,36,1,1,0,36,26,10,6,6,0,12,12,0,0,0,0,93,79,14,18,14,4,1,0,1,30,23,7
2019,194824,Computer Science,1,Master's degree,34,27,7,0,0,0,5,4,1,1,1,0,0,0,0,0,0,0,16,15,1,1,1,0,0,0,0,11,6,5
2019,194824,"Aerospace, Aeronautical, and Astronautical/Space Engineering, General",1,Bachelor's degree,77,63,14,0,0,0,5,5,0,1,1,0,11,8,3,0,0,0,51,42,9,6,4,2,1,1,0,2,2,0
2019,194824,"Aerospace, Aeronautical, and Astronautical/Space Engineering, General",1,Master's degree,13,10,3,0,0,0,1,1,0,1,0,1,0,0,0,0,0,0,10,9,1,0,0,0,0,0,0,1,0,1
2019,194824,Bioengineering and Biomedical Engineering,1,Bachelor's degree,85,33,52,0,0,0,5,1,4,0,0,0,15,9,6,0,0,0,52,19,33,7,2,5,0,0,0,6,2,4
2019,194824,Bioengineering and Biomedical Engineering,1,Master's degree,13,5,8,0,0,0,4,1,3,0,0,0,1,0,1,0,0,0,4,2,2,2,0,2,0,0,0,2,2,0
2019,194824,Chemical Engineering,1,Bachelor's degree,115,64,51,0,0,0,12,8,4,3,2,1,6,5,1,0,0,0,70,37,33,11,3,8,1,1,0,12,8,4
2019,194824,Chemical Engineering,1,Master's degree,2,2,0,0,0,0,0,0,0,0,0,0,0,0,0,0,0,0,0,0,0,0,0,0,0,0,0,2,2,0
2019,194824,"Civil Engineering, General",1,Bachelor's degree,52,36,16,0,0,0,5,4,1,6,5,1,2,2,0,0,0,0,34,22,12,2,0,2,1,1,0,2,2,0
2019,194824,"Civil Engineering, General",1,Master's degree,16,8,8,0,0,0,1,1,0,0,0,0,1,1,0,0,0,0,10,3,7,2,2,0,0,0,0,2,1,1
2019,194824,Transportation and Highway Engineering,1,Master's degree,0,0,0,0,0,0,0,0,0,0,0,0,0,0,0,0,0,0,0,0,0,0,0,0,0,0,0,0,0,0
2019,194824,Electrical and Electronics Engineering,1,Bachelor's degree,83,56,27,0,0,0,6,3,3,4,4,0,5,4,1,0,0,0,32,25,7,6,2,4,2,2,0,28,16,12
2019,194824,Electrical and Electronics Engineering,1,Master's degree,28,21,7,0,0,0,2,2,0,2,2,0,0,0,0,0,0,0,8,5,3,1,0,1,0,0,0,15,12,3
2019,194824,Engineering Physics/Applied Physics,1,Bachelor's degree,0,0,0,0,0,0,0,0,0,0,0,0,0,0,0,0,0,0,0,0,0,0,0,0,0,0,0,0,0,0
2019,194824,Engineering Physics/Applied Physics,1,Master's degree,0,0,0,0,0,0,0,0,0,0,0,0,0,0,0,0,0,0,0,0,0,0,0,0,0,0,0,0,0,0
2019,194824,Engineering Science,1,Bachelor's degree,0,0,0,0,0,0,0,0,0,0,0,0,0,0,0,0,0,0,0,0,0,0,0,0,0,0,0,0,0,0
2019,194824,Engineering Science,1,Master's degree,0,0,0,0,0,0,0,0,0,0,0,0,0,0,0,0,0,0,0,0,0,0,0,0,0,0,0,0,0,0
2019,194824,Environmental/Environmental Health Engineering,1,Bachelor's degree,13,5,8,0,0,0,0,0,0,0,0,0,0,0,0,0,0,0,11,5,6,2,0,2,0,0,0,0,0,0
2019,194824,Environmental/Environmental Health Engineering,1,Master's degree,2,0,2,0,0,0,0,0,0,0,0,0,0,0,0,0,0,0,2,0,2,0,0,0,0,0,0,0,0,0
2019,194824,Materials Engineering,1,Bachelor's degree,26,17,9,0,0,0,1,1,0,0,0,0,2,2,0,0,0,0,13,8,5,6,3,3,1,1,0,3,2,1
2019,194824,Materials Engineering,1,Master's degree,6,6,0,0,0,0,0,0,0,0,0,0,0,0,0,0,0,0,4,4,0,0,0,0,0,0,0,2,2,0
2019,194824,Mechanical Engineering,1,Bachelor's degree,191,148,43,0,0,0,15,9,6,10,7,3,10,10,0,0,0,0,124,98,26,8,5,3,6,3,3,18,16,2
2019,194824,Mechanical Engineering,1,Master's degree,22,18,4,0,0,0,0,0,0,0,0,0,2,2,0,0,0,0,14,11,3,3,3,0,1,1,0,2,1,1
2019,194824,Nuclear Engineering,1,Bachelor's degree,22,14,8,0,0,0,0,0,0,0,0,0,3,1,2,0,0,0,17,11,6,1,1,0,1,1,0,0,0,0
2019,194824,Nuclear Engineering,1,Master's degree,4,3,1,0,0,0,1,1,0,0,0,0,0,0,0,0,0,0,3,2,1,0,0,0,0,0,0,0,0,0
2019,194824,Systems Engineering,1,Master's degree,4,3,1,0,0,0,1,1,0,0,0,0,0,0,0,0,0,0,3,2,1,0,0,0,0,0,0,0,0,0
2019,194824,Industrial Engineering,1,Bachelor's degree,33,23,10,0,0,0,3,2,1,0,0,0,3,2,1,0,0,0,21,16,5,4,2,2,0,0,0,2,1,1
2019,194824,Industrial Engineering,1,Master's degree,1,0,1,0,0,0,0,0,0,0,0,0,0,0,0,0,0,0,0,0,0,0,0,0,0,0,0,1,0,1
2019,194824,Operations Research,1,Master's degree,0,0,0,0,0,0,0,0,0,0,0,0,0,0,0,0,0,0,0,0,0,0,0,0,0,0,0,0,0,0
2019,194824,Computer/Computer Systems Technology/Technician,1,Bachelor's degree,72,59,13,0,0,0,8,7,1,4,3,1,4,4,0,0,0,0,36,31,5,5,4,1,0,0,0,15,10,5
2019,194824,Computer/Computer Systems Technology/Technician,1,Master's degree,5,4,1,0,0,0,0,0,0,0,0,0,0,0,0,0,0,0,0,0,0,0,0,0,1,1,0,4,3,1
2019,194824,Pre-Law Studies,1,Bachelor's degree,0,0,0,0,0,0,0,0,0,0,0,0,0,0,0,0,0,0,0,0,0,0,0,0,0,0,0,0,0,0
2019,194824,"Biology/Biological Sciences, General",1,Bachelor's degree,20,7,13,0,0,0,2,0,2,1,0,1,3,1,2,0,0,0,12,5,7,0,0,0,0,0,0,2,1,1
2019,194824,"Biology/Biological Sciences, General",1,Master's degree,4,1,3,0,0,0,0,0,0,0,0,0,0,0,0,0,0,0,4,1,3,0,0,0,0,0,0,0,0,0
2019,194824,Biochemistry and Molecular Biology,1,Bachelor's degree,0,0,0,0,0,0,0,0,0,0,0,0,0,0,0,0,0,0,0,0,0,0,0,0,0,0,0,0,0,0
2019,194824,Biochemistry and Molecular Biology,1,Master's degree,0,0,0,0,0,0,0,0,0,0,0,0,0,0,0,0,0,0,0,0,0,0,0,0,0,0,0,0,0,0
2019,194824,"Biochemistry, Biophysics and Molecular Biology, Other",1,Bachelor's degree,16,6,10,0,0,0,1,0,1,0,0,0,1,0,1,0,0,0,12,6,6,2,0,2,0,0,0,0,0,0
2019,194824,"Biochemistry, Biophysics and Molecular Biology, Other",1,Master's degree,1,1,0,0,0,0,0,0,0,0,0,0,0,0,0,0,0,0,0,0,0,1,1,0,0,0,0,0,0,0
2019,194824,Bioinformatics,1,Bachelor's degree,3,1,2,0,0,0,0,0,0,0,0,0,0,0,0,0,0,0,2,1,1,1,0,1,0,0,0,0,0,0
2019,194824,"Biological and Biomedical Sciences, Other",1,Bachelor's degree,0,0,0,0,0,0,0,0,0,0,0,0,0,0,0,0,0,0,0,0,0,0,0,0,0,0,0,0,0,0
2019,194824,"Mathematics, General",1,Bachelor's degree,43,30,13,0,0,0,6,4,2,2,0,2,2,1,1,0,0,0,15,11,4,3,1,2,1,1,0,14,12,2
2019,194824,"Mathematics, General",1,Master's degree,0,0,0,0,0,0,0,0,0,0,0,0,0,0,0,0,0,0,0,0,0,0,0,0,0,0,0,0,0,0
2019,194824,"Applied Mathematics, General",1,Master's degree,10,7,3,0,0,0,1,1,0,1,0,1,0,0,0,0,0,0,5,4,1,1,0,1,0,0,0,2,2,0
2019,194824,Financial Mathematics,1,Master's degree,38,28,10,0,0,0,3,3,0,1,1,0,2,1,1,0,0,0,6,6,0,1,1,0,0,0,0,25,16,9
2019,194824,"Multi-/Interdisciplinary Studies, General",1,Bachelor's degree,2,1,1,0,0,0,0,0,0,0,0,0,2,1,1,0,0,0,0,0,0,0,0,0,0,0,0,0,0,0
2019,194824,"Multi-/Interdisciplinary Studies, General",1,Master's degree,1,1,0,0,0,0,0,0,0,0,0,0,0,0,0,0,0,0,1,1,0,0,0,0,0,0,0,0,0,0
2019,194824,"Science, Technology and Society",1,Bachelor's degree,1,0,1,0,0,0,0,0,0,0,0,0,1,0,1,0,0,0,0,0,0,0,0,0,0,0,0,0,0,0
2019,194824,"Science, Technology and Society",1,Master's degree,3,2,1,0,0,0,0,0,0,0,0,0,0,0,0,0,0,0,3,2,1,0,0,0,0,0,0,0,0,0
2019,194824,Natural Sciences,1,Master's degree,0,0,0,0,0,0,0,0,0,0,0,0,0,0,0,0,0,0,0,0,0,0,0,0,0,0,0,0,0,0
2019,194824,"Cognitive Science, General",1,Bachelor's degree,7,0,7,0,0,0,1,0,1,0,0,0,1,0,1,0,0,0,2,0,2,1,0,1,0,0,0,2,0,2
2019,194824,"Cognitive Science, General",1,Master's degree,1,1,0,0,0,0,0,0,0,0,0,0,0,0,0,0,0,0,1,1,0,0,0,0,0,0,0,0,0,0
2019,194824,Human Computer Interaction,1,Master's degree,0,0,0,0,0,0,0,0,0,0,0,0,0,0,0,0,0,0,0,0,0,0,0,0,0,0,0,0,0,0
2019,194824,Sustainability Studies,1,Bachelor's degree,0,0,0,0,0,0,0,0,0,0,0,0,0,0,0,0,0,0,0,0,0,0,0,0,0,0,0,0,0,0
2019,194824,"Multi-/Interdisciplinary Studies, Other",1,Bachelor's degree,9,8,1,0,0,0,1,1,0,1,1,0,0,0,0,0,0,0,5,4,1,1,1,0,0,0,0,1,1,0
2019,194824,"Multi-/Interdisciplinary Studies, Other",1,Master's degree,0,0,0,0,0,0,0,0,0,0,0,0,0,0,0,0,0,0,0,0,0,0,0,0,0,0,0,0,0,0
2019,194824,Philosophy,1,Bachelor's degree,1,1,0,0,0,0,0,0,0,0,0,0,1,1,0,0,0,0,0,0,0,0,0,0,0,0,0,0,0,0
2019,194824,Philosophy,1,Master's degree,0,0,0,0,0,0,0,0,0,0,0,0,0,0,0,0,0,0,0,0,0,0,0,0,0,0,0,0,0,0
2019,194824,Astronomy,1,Master's degree,0,0,0,0,0,0,0,0,0,0,0,0,0,0,0,0,0,0,0,0,0,0,0,0,0,0,0,0,0,0
2019,194824,"Chemistry, General",1,Bachelor's degree,23,10,13,0,0,0,3,1,2,0,0,0,2,1,1,0,0,0,18,8,10,0,0,0,0,0,0,0,0,0
2019,194824,"Chemistry, General",1,Master's degree,3,1,2,0,0,0,0,0,0,1,0,1,0,0,0,0,0,0,2,1,1,0,0,0,0,0,0,0,0,0
2019,194824,"Geology/Earth Science, General",1,Bachelor's degree,3,1,2,0,0,0,0,0,0,0,0,0,1,1,0,0,0,0,2,0,2,0,0,0,0,0,0,0,0,0
2019,194824,"Geology/Earth Science, General",1,Master's degree,0,0,0,0,0,0,0,0,0,0,0,0,0,0,0,0,0,0,0,0,0,0,0,0,0,0,0,0,0,0
2019,194824,Hydrology and Water Resources Science,1,Bachelor's degree,0,0,0,0,0,0,0,0,0,0,0,0,0,0,0,0,0,0,0,0,0,0,0,0,0,0,0,0,0,0
2019,194824,Hydrology and Water Resources Science,1,Master's degree,0,0,0,0,0,0,0,0,0,0,0,0,0,0,0,0,0,0,0,0,0,0,0,0,0,0,0,0,0,0
2019,194824,"Physics, General",1,Bachelor's degree,25,23,2,0,0,0,1,1,0,0,0,0,2,2,0,0,0,0,18,17,1,1,1,0,1,0,1,2,2,0
2019,194824,"Physics, General",1,Master's degree,8,8,0,0,0,0,0,0,0,0,0,0,0,0,0,0,0,0,6,6,0,1,1,0,0,0,0,1,1,0
2019,194824,"Physics, Other",1,Bachelor's degree,14,10,4,0,0,0,0,0,0,0,0,0,1,1,0,0,0,0,12,9,3,1,0,1,0,0,0,0,0,0
2019,194824,"Physical Sciences, Other",1,Bachelor's degree,0,0,0,0,0,0,0,0,0,0,0,0,0,0,0,0,0,0,0,0,0,0,0,0,0,0,0,0,0,0
2019,194824,"Physical Sciences, Other",1,Master's degree,0,0,0,0,0,0,0,0,0,0,0,0,0,0,0,0,0,0,0,0,0,0,0,0,0,0,0,0,0,0
2019,194824,"Psychology, General",1,Bachelor's degree,8,4,4,0,0,0,0,0,0,2,1,1,0,0,0,0,0,0,4,1,3,1,1,0,0,0,0,1,1,0
2019,194824,"Psychology, General",1,Master's degree,0,0,0,0,0,0,0,0,0,0,0,0,0,0,0,0,0,0,0,0,0,0,0,0,0,0,0,0,0,0
2019,194824,"Social Sciences, General",1,Bachelor's degree,0,0,0,0,0,0,0,0,0,0,0,0,0,0,0,0,0,0,0,0,0,0,0,0,0,0,0,0,0,0
2019,194824,"Social Sciences, General",1,Master's degree,0,0,0,0,0,0,0,0,0,0,0,0,0,0,0,0,0,0,0,0,0,0,0,0,0,0,0,0,0,0
2019,194824,"Economics, General",1,Bachelor's degree,6,5,1,0,0,0,0,0,0,1,1,0,0,0,0,0,0,0,3,2,1,0,0,0,0,0,0,2,2,0
2019,194824,"Economics, General",1,Master's degree,1,0,1,0,0,0,0,0,0,0,0,0,0,0,0,0,0,0,1,0,1,0,0,0,0,0,0,0,0,0
2019,194824,"Economics, Other",1,Master's degree,0,0,0,0,0,0,0,0,0,0,0,0,0,0,0,0,0,0,0,0,0,0,0,0,0,0,0,0,0,0
2019,194824,"Social Sciences, Other",1,Master's degree,0,0,0,0,0,0,0,0,0,0,0,0,0,0,0,0,0,0,0,0,0,0,0,0,0,0,0,0,0,0
2019,194824,"Visual and Performing Arts, General",1,Bachelor's degree,4,2,2,0,0,0,0,0,0,0,0,0,0,0,0,0,0,0,3,1,2,0,0,0,0,0,0,1,1,0
2019,194824,"Visual and Performing Arts, General",1,Master's degree,0,0,0,0,0,0,0,0,0,0,0,0,0,0,0,0,0,0,0,0,0,0,0,0,0,0,0,0,0,0
2019,194824,Game and Interactive Media Design,1,Bachelor's degree,27,19,8,0,0,0,4,3,1,0,0,0,2,1,1,0,0,0,20,15,5,1,0,1,0,0,0,0,0,0
2019,194824,Music Theory and Composition,1,Bachelor's degree,0,0,0,0,0,0,0,0,0,0,0,0,0,0,0,0,0,0,0,0,0,0,0,0,0,0,0,0,0,0
2019,194824,Pre-Medicine/Pre-Medical Studies,1,Bachelor's degree,12,5,7,0,0,0,9,2,7,0,0,0,0,0,0,0,0,0,2,2,0,1,1,0,0,0,0,0,0,0
2019,194824,"Business Administration and Management, General",1,Bachelor's degree,76,51,25,1,1,0,12,6,6,5,3,2,6,5,1,0,0,0,31,21,10,4,4,0,0,0,0,17,11,6
2019,194824,"Business Administration and Management, General",1,Master's degree,28,17,11,0,0,0,1,1,0,1,1,0,3,0,3,0,0,0,17,12,5,2,1,1,0,0,0,4,2,2
2019,194824,"Logistics, Materials, and Supply Chain Management",1,Master's degree,0,0,0,0,0,0,0,0,0,0,0,0,0,0,0,0,0,0,0,0,0,0,0,0,0,0,0,0,0,0
2019,194824,Entrepreneurship/Entrepreneurial Studies,1,Master's degree,8,3,5,0,0,0,0,0,0,2,1,1,2,0,2,0,0,0,2,1,1,1,0,1,0,0,0,1,1,0
2019,194824,"Finance and Financial Management Services, Other",1,Master's degree,0,0,0,0,0,0,0,0,0,0,0,0,0,0,0,0,0,0,0,0,0,0,0,0,0,0,0,0,0,0
2019,194824,Business Statistics,1,Master's degree,41,18,23,0,0,0,3,1,2,0,0,0,0,0,0,0,0,0,6,3,3,1,1,0,1,1,0,30,12,18
2019,194824,"Management Sciences and Quantitative Methods, Other",1,Master's degree,11,6,5,0,0,0,0,0,0,0,0,0,2,2,0,0,0,0,5,3,2,0,0,0,0,0,0,4,1,3
2019,194824,"Business, Management, Marketing, and Related Support Services, Other",1,Master's degree,0,0,0,0,0,0,0,0,0,0,0,0,0,0,0,0,0,0,0,0,0,0,0,0,0,0,0,0,0,0
2019,194824,99,1,Bachelor's degree,1359,908,451,2,2,0,142,87,55,49,35,14,108,79,29,0,0,0,764,521,243,101,52,49,17,11,6,176,121,55
2019,194824,99,1,Master's degree,368,235,133,0,0,0,28,21,7,11,7,4,13,6,7,0,0,0,150,103,47,20,13,7,6,6,0,140,79,61
2018,194824,Environmental Science,1,Bachelor's degree,4,1,3,0,0,0,0,0,0,0,0,0,0,0,0,0,0,0,3,0,3,0,0,0,0,0,0,1,1,0
2018,194824,Architecture,1,Bachelor's degree,44,14,30,0,0,0,3,1,2,2,2,0,5,3,2,0,0,0,19,3,16,6,0,6,1,1,0,8,4,4
2018,194824,Architecture,1,Master's degree,13,6,7,0,0,0,1,1,0,1,0,1,1,0,1,0,0,0,7,4,3,0,0,0,0,0,0,3,1,2
2018,194824,Architectural and Building Sciences/Technology,1,Bachelor's degree,0,0,0,0,0,0,0,0,0,0,0,0,0,0,0,0,0,0,0,0,0,0,0,0,0,0,0,0,0,0
2018,194824,Architectural and Building Sciences/Technology,1,Master's degree,8,2,6,0,0,0,1,0,1,0,0,0,0,0,0,0,0,0,4,1,3,0,0,0,0,0,0,3,1,2
2018,194824,"Architecture and Related Services, Other",1,Bachelor's degree,0,0,0,0,0,0,0,0,0,0,0,0,0,0,0,0,0,0,0,0,0,0,0,0,0,0,0,0,0,0
2018,194824,"Architecture and Related Services, Other",1,Master's degree,4,1,3,0,0,0,0,0,0,1,0,1,0,0,0,0,0,0,3,1,2,0,0,0,0,0,0,0,0,0
2018,194824,"Communication, General",1,Bachelor's degree,1,0,1,0,0,0,0,0,0,0,0,0,1,0,1,0,0,0,0,0,0,0,0,0,0,0,0,0,0,0
2018,194824,Speech Communication and Rhetoric,1,Bachelor's degree,0,0,0,0,0,0,0,0,0,0,0,0,0,0,0,0,0,0,0,0,0,0,0,0,0,0,0,0,0,0
2018,194824,Speech Communication and Rhetoric,1,Master's degree,0,0,0,0,0,0,0,0,0,0,0,0,0,0,0,0,0,0,0,0,0,0,0,0,0,0,0,0,0,0
2018,194824,Digital Communication and Media/Multimedia,1,Bachelor's degree,12,5,7,0,0,0,0,0,0,2,0,2,0,0,0,0,0,0,5,3,2,1,0,1,0,0,0,4,2,2
2018,194824,Technical and Scientific Communication,1,Master's degree,0,0,0,0,0,0,0,0,0,0,0,0,0,0,0,0,0,0,0,0,0,0,0,0,0,0,0,0,0,0
2018,194824,"Computer and Information Sciences, General",1,Bachelor's degree,0,0,0,0,0,0,0,0,0,0,0,0,0,0,0,0,0,0,0,0,0,0,0,0,0,0,0,0,0,0
2018,194824,"Computer and Information Sciences, General",1,Master's degree,0,0,0,0,0,0,0,0,0,0,0,0,0,0,0,0,0,0,0,0,0,0,0,0,0,0,0,0,0,0
2018,194824,Information Technology,1,Bachelor's degree,29,19,10,0,0,0,5,3,2,3,2,1,2,1,1,0,0,0,13,9,4,2,1,1,2,1,1,2,2,0
2018,194824,Information Technology,1,Master's degree,22,16,6,0,0,0,1,1,0,0,0,0,1,0,1,0,0,0,4,3,1,0,0,0,1,1,0,15,11,4
2018,194824,Computer Science,1,Bachelor's degree,208,174,34,0,0,0,41,32,9,3,2,1,16,12,4,1,1,0,104,93,11,14,12,2,4,4,0,25,18,7
2018,194824,Computer Science,1,Master's degree,38,33,5,0,0,0,8,6,2,1,1,0,1,1,0,0,0,0,18,17,1,2,2,0,0,0,0,8,6,2
2018,194824,"Aerospace, Aeronautical, and Astronautical/Space Engineering, General",1,Bachelor's degree,85,67,18,0,0,0,3,3,0,3,1,2,7,7,0,0,0,0,57,47,10,7,4,3,1,1,0,7,4,3
2018,194824,"Aerospace, Aeronautical, and Astronautical/Space Engineering, General",1,Master's degree,12,9,3,0,0,0,1,1,0,0,0,0,2,2,0,0,0,0,9,6,3,0,0,0,0,0,0,0,0,0
2018,194824,Bioengineering and Biomedical Engineering,1,Bachelor's degree,97,47,50,0,0,0,14,7,7,5,2,3,7,4,3,0,0,0,56,24,32,9,5,4,1,1,0,5,4,1
2018,194824,Bioengineering and Biomedical Engineering,1,Master's degree,22,11,11,0,0,0,1,0,1,0,0,0,2,1,1,0,0,0,16,8,8,1,1,0,1,1,0,1,0,1
2018,194824,Chemical Engineering,1,Bachelor's degree,109,63,46,0,0,0,11,6,5,2,2,0,5,3,2,0,0,0,75,45,30,8,1,7,0,0,0,8,6,2
2018,194824,Chemical Engineering,1,Master's degree,4,3,1,0,0,0,0,0,0,0,0,0,1,1,0,0,0,0,1,1,0,1,1,0,0,0,0,1,0,1
2018,194824,"Civil Engineering, General",1,Bachelor's degree,47,26,21,0,0,0,3,2,1,1,1,0,2,1,1,0,0,0,33,16,17,4,4,0,0,0,0,4,2,2
2018,194824,"Civil Engineering, General",1,Master's degree,11,7,4,0,0,0,1,1,0,1,1,0,0,0,0,0,0,0,6,4,2,1,0,1,1,0,1,1,1,0
2018,194824,Transportation and Highway Engineering,1,Master's degree,1,1,0,0,0,0,0,0,0,0,0,0,0,0,0,0,0,0,0,0,0,0,0,0,0,0,0,1,1,0
2018,194824,Electrical and Electronics Engineering,1,Bachelor's degree,100,78,22,0,0,0,5,2,3,3,2,1,3,3,0,0,0,0,54,46,8,12,8,4,4,3,1,19,14,5
2018,194824,Electrical and Electronics Engineering,1,Master's degree,19,14,5,0,0,0,0,0,0,0,0,0,1,0,1,0,0,0,7,6,1,0,0,0,0,0,0,11,8,3
2018,194824,Engineering Physics/Applied Physics,1,Bachelor's degree,0,0,0,0,0,0,0,0,0,0,0,0,0,0,0,0,0,0,0,0,0,0,0,0,0,0,0,0,0,0
2018,194824,Engineering Physics/Applied Physics,1,Master's degree,0,0,0,0,0,0,0,0,0,0,0,0,0,0,0,0,0,0,0,0,0,0,0,0,0,0,0,0,0,0
2018,194824,Engineering Science,1,Bachelor's degree,0,0,0,0,0,0,0,0,0,0,0,0,0,0,0,0,0,0,0,0,0,0,0,0,0,0,0,0,0,0
2018,194824,Engineering Science,1,Master's degree,0,0,0,0,0,0,0,0,0,0,0,0,0,0,0,0,0,0,0,0,0,0,0,0,0,0,0,0,0,0
2018,194824,Environmental/Environmental Health Engineering,1,Bachelor's degree,17,8,9,0,0,0,1,0,1,1,1,0,0,0,0,0,0,0,11,4,7,1,1,0,0,0,0,3,2,1
2018,194824,Environmental/Environmental Health Engineering,1,Master's degree,7,0,7,0,0,0,1,0,1,0,0,0,0,0,0,0,0,0,6,0,6,0,0,0,0,0,0,0,0,0
2018,194824,Materials Engineering,1,Bachelor's degree,34,17,17,0,0,0,3,0,3,0,0,0,2,1,1,0,0,0,22,10,12,2,2,0,0,0,0,5,4,1
2018,194824,Materials Engineering,1,Master's degree,6,4,2,0,0,0,0,0,0,0,0,0,0,0,0,0,0,0,5,3,2,0,0,0,0,0,0,1,1,0
2018,194824,Mechanical Engineering,1,Bachelor's degree,192,153,39,1,1,0,8,6,2,5,5,0,16,11,5,0,0,0,119,98,21,15,11,4,3,3,0,25,18,7
2018,194824,Mechanical Engineering,1,Master's degree,27,21,6,0,0,0,1,1,0,0,0,0,2,1,1,0,0,0,20,16,4,0,0,0,0,0,0,4,3,1
2018,194824,Nuclear Engineering,1,Bachelor's degree,16,12,4,0,0,0,1,1,0,0,0,0,2,1,1,0,0,0,11,8,3,1,1,0,0,0,0,1,1,0
2018,194824,Nuclear Engineering,1,Master's degree,3,3,0,0,0,0,0,0,0,0,0,0,0,0,0,0,0,0,2,2,0,0,0,0,0,0,0,1,1,0
2018,194824,Systems Engineering,1,Master's degree,5,4,1,0,0,0,0,0,0,1,1,0,2,1,1,0,0,0,1,1,0,0,0,0,0,0,0,1,1,0
2018,194824,Industrial Engineering,1,Bachelor's degree,47,31,16,0,0,0,6,4,2,4,3,1,4,1,3,0,0,0,20,15,5,5,2,3,1,0,1,7,6,1
2018,194824,Industrial Engineering,1,Master's degree,7,2,5,0,0,0,0,0,0,1,0,1,1,0,1,0,0,0,4,2,2,0,0,0,0,0,0,1,0,1
2018,194824,Operations Research,1,Master's degree,0,0,0,0,0,0,0,0,0,0,0,0,0,0,0,0,0,0,0,0,0,0,0,0,0,0,0,0,0,0
2018,194824,Computer/Computer Systems Technology/Technician,1,Bachelor's degree,64,56,8,0,0,0,10,8,2,0,0,0,2,2,0,0,0,0,36,33,3,5,5,0,2,2,0,9,6,3
2018,194824,Computer/Computer Systems Technology/Technician,1,Master's degree,10,9,1,0,0,0,0,0,0,0,0,0,1,1,0,0,0,0,2,1,1,0,0,0,0,0,0,7,7,0
2018,194824,Pre-Law Studies,1,Bachelor's degree,1,0,1,0,0,0,0,0,0,0,0,0,0,0,0,0,0,0,1,0,1,0,0,0,0,0,0,0,0,0
2018,194824,"Biology/Biological Sciences, General",1,Bachelor's degree,25,8,17,0,0,0,4,1,3,3,0,3,1,0,1,0,0,0,12,5,7,3,1,2,1,1,0,1,0,1
2018,194824,"Biology/Biological Sciences, General",1,Master's degree,3,0,3,0,0,0,0,0,0,0,0,0,0,0,0,0,0,0,3,0,3,0,0,0,0,0,0,0,0,0
2018,194824,Biochemistry and Molecular Biology,1,Bachelor's degree,0,0,0,0,0,0,0,0,0,0,0,0,0,0,0,0,0,0,0,0,0,0,0,0,0,0,0,0,0,0
2018,194824,Biochemistry and Molecular Biology,1,Master's degree,0,0,0,0,0,0,0,0,0,0,0,0,0,0,0,0,0,0,0,0,0,0,0,0,0,0,0,0,0,0
2018,194824,"Biochemistry, Biophysics and Molecular Biology, Other",1,Bachelor's degree,20,6,14,0,0,0,4,3,1,0,0,0,0,0,0,0,0,0,12,2,10,3,0,3,0,0,0,1,1,0
2018,194824,"Biochemistry, Biophysics and Molecular Biology, Other",1,Master's degree,3,1,2,0,0,0,1,1,0,0,0,0,0,0,0,0,0,0,1,0,1,1,0,1,0,0,0,0,0,0
2018,194824,Bioinformatics,1,Bachelor's degree,5,2,3,0,0,0,1,1,0,1,0,1,0,0,0,0,0,0,3,1,2,0,0,0,0,0,0,0,0,0
2018,194824,"Biological and Biomedical Sciences, Other",1,Bachelor's degree,0,0,0,0,0,0,0,0,0,0,0,0,0,0,0,0,0,0,0,0,0,0,0,0,0,0,0,0,0,0
2018,194824,"Mathematics, General",1,Bachelor's degree,49,32,17,0,0,0,5,4,1,0,0,0,1,1,0,0,0,0,20,12,8,4,4,0,0,0,0,19,11,8
2018,194824,"Mathematics, General",1,Master's degree,1,1,0,0,0,0,0,0,0,0,0,0,0,0,0,0,0,0,0,0,0,0,0,0,0,0,0,1,1,0
2018,194824,"Applied Mathematics, General",1,Master's degree,19,11,8,0,0,0,2,0,2,0,0,0,2,1,1,0,0,0,9,6,3,0,0,0,1,1,0,5,3,2
2018,194824,Financial Mathematics,1,Master's degree,52,25,27,0,0,0,0,0,0,1,0,1,0,0,0,0,0,0,6,6,0,0,0,0,2,1,1,43,18,25
2018,194824,"Multi-/Interdisciplinary Studies, General",1,Bachelor's degree,0,0,0,0,0,0,0,0,0,0,0,0,0,0,0,0,0,0,0,0,0,0,0,0,0,0,0,0,0,0
2018,194824,"Multi-/Interdisciplinary Studies, General",1,Master's degree,2,2,0,0,0,0,0,0,0,0,0,0,0,0,0,0,0,0,2,2,0,0,0,0,0,0,0,0,0,0
2018,194824,"Science, Technology and Society",1,Bachelor's degree,3,2,1,0,0,0,0,0,0,1,1,0,0,0,0,0,0,0,2,1,1,0,0,0,0,0,0,0,0,0
2018,194824,"Science, Technology and Society",1,Master's degree,2,0,2,0,0,0,0,0,0,0,0,0,0,0,0,0,0,0,1,0,1,0,0,0,0,0,0,1,0,1
2018,194824,Natural Sciences,1,Master's degree,0,0,0,0,0,0,0,0,0,0,0,0,0,0,0,0,0,0,0,0,0,0,0,0,0,0,0,0,0,0
2018,194824,"Cognitive Science, General",1,Bachelor's degree,4,2,2,0,0,0,1,0,1,0,0,0,0,0,0,0,0,0,2,1,1,0,0,0,0,0,0,1,1,0
2018,194824,"Cognitive Science, General",1,Master's degree,1,1,0,0,0,0,0,0,0,0,0,0,0,0,0,0,0,0,1,1,0,0,0,0,0,0,0,0,0,0
2018,194824,Human Computer Interaction,1,Master's degree,0,0,0,0,0,0,0,0,0,0,0,0,0,0,0,0,0,0,0,0,0,0,0,0,0,0,0,0,0,0
2018,194824,Sustainability Studies,1,Bachelor's degree,2,0,2,0,0,0,0,0,0,0,0,0,0,0,0,0,0,0,1,0,1,1,0,1,0,0,0,0,0,0
2018,194824,"Multi-/Interdisciplinary Studies, Other",1,Bachelor's degree,15,4,11,0,0,0,0,0,0,0,0,0,2,1,1,0,0,0,12,3,9,1,0,1,0,0,0,0,0,0
2018,194824,"Multi-/Interdisciplinary Studies, Other",1,Master's degree,0,0,0,0,0,0,0,0,0,0,0,0,0,0,0,0,0,0,0,0,0,0,0,0,0,0,0,0,0,0
2018,194824,Philosophy,1,Bachelor's degree,0,0,0,0,0,0,0,0,0,0,0,0,0,0,0,0,0,0,0,0,0,0,0,0,0,0,0,0,0,0
2018,194824,Philosophy,1,Master's degree,0,0,0,0,0,0,0,0,0,0,0,0,0,0,0,0,0,0,0,0,0,0,0,0,0,0,0,0,0,0
2018,194824,Astronomy,1,Master's degree,1,0,1,0,0,0,0,0,0,0,0,0,0,0,0,0,0,0,1,0,1,0,0,0,0,0,0,0,0,0
2018,194824,"Chemistry, General",1,Bachelor's degree,17,12,5,0,0,0,0,0,0,0,0,0,0,0,0,0,0,0,15,10,5,0,0,0,0,0,0,2,2,0
2018,194824,"Chemistry, General",1,Master's degree,1,1,0,0,0,0,0,0,0,0,0,0,0,0,0,0,0,0,1,1,0,0,0,0,0,0,0,0,0,0
2018,194824,"Geology/Earth Science, General",1,Bachelor's degree,1,0,1,0,0,0,0,0,0,0,0,0,0,0,0,0,0,0,1,0,1,0,0,0,0,0,0,0,0,0
2018,194824,"Geology/Earth Science, General",1,Master's degree,4,2,2,0,0,0,0,0,0,0,0,0,0,0,0,0,0,0,4,2,2,0,0,0,0,0,0,0,0,0
2018,194824,Hydrology and Water Resources Science,1,Bachelor's degree,0,0,0,0,0,0,0,0,0,0,0,0,0,0,0,0,0,0,0,0,0,0,0,0,0,0,0,0,0,0
2018,194824,Hydrology and Water Resources Science,1,Master's degree,0,0,0,0,0,0,0,0,0,0,0,0,0,0,0,0,0,0,0,0,0,0,0,0,0,0,0,0,0,0
2018,194824,"Physics, General",1,Bachelor's degree,20,16,4,0,0,0,1,1,0,1,0,1,1,1,0,0,0,0,16,13,3,1,1,0,0,0,0,0,0,0
2018,194824,"Physics, General",1,Master's degree,6,5,1,0,0,0,0,0,0,0,0,0,1,1,0,0,0,0,4,4,0,0,0,0,0,0,0,1,0,1
2018,194824,"Physics, Other",1,Bachelor's degree,8,7,1,0,0,0,0,0,0,0,0,0,1,0,1,0,0,0,6,6,0,1,1,0,0,0,0,0,0,0
2018,194824,"Physical Sciences, Other",1,Bachelor's degree,0,0,0,0,0,0,0,0,0,0,0,0,0,0,0,0,0,0,0,0,0,0,0,0,0,0,0,0,0,0
2018,194824,"Physical Sciences, Other",1,Master's degree,0,0,0,0,0,0,0,0,0,0,0,0,0,0,0,0,0,0,0,0,0,0,0,0,0,0,0,0,0,0
2018,194824,"Psychology, General",1,Bachelor's degree,7,6,1,0,0,0,1,1,0,1,1,0,2,2,0,0,0,0,3,2,1,0,0,0,0,0,0,0,0,0
2018,194824,"Psychology, General",1,Master's degree,0,0,0,0,0,0,0,0,0,0,0,0,0,0,0,0,0,0,0,0,0,0,0,0,0,0,0,0,0,0
2018,194824,"Social Sciences, General",1,Bachelor's degree,0,0,0,0,0,0,0,0,0,0,0,0,0,0,0,0,0,0,0,0,0,0,0,0,0,0,0,0,0,0
2018,194824,"Social Sciences, General",1,Master's degree,0,0,0,0,0,0,0,0,0,0,0,0,0,0,0,0,0,0,0,0,0,0,0,0,0,0,0,0,0,0
2018,194824,"Economics, General",1,Bachelor's degree,6,3,3,0,0,0,0,0,0,0,0,0,3,2,1,0,0,0,2,1,1,0,0,0,0,0,0,1,0,1
2018,194824,"Economics, General",1,Master's degree,0,0,0,0,0,0,0,0,0,0,0,0,0,0,0,0,0,0,0,0,0,0,0,0,0,0,0,0,0,0
2018,194824,"Economics, Other",1,Master's degree,0,0,0,0,0,0,0,0,0,0,0,0,0,0,0,0,0,0,0,0,0,0,0,0,0,0,0,0,0,0
2018,194824,"Social Sciences, Other",1,Master's degree,0,0,0,0,0,0,0,0,0,0,0,0,0,0,0,0,0,0,0,0,0,0,0,0,0,0,0,0,0,0
2018,194824,"Visual and Performing Arts, General",1,Bachelor's degree,5,2,3,0,0,0,3,0,3,0,0,0,1,1,0,0,0,0,1,1,0,0,0,0,0,0,0,0,0,0
2018,194824,"Visual and Performing Arts, General",1,Master's degree,2,0,2,0,0,0,0,0,0,0,0,0,0,0,0,0,0,0,1,0,1,1,0,1,0,0,0,0,0,0
2018,194824,Game and Interactive Media Design,1,Bachelor's degree,27,16,11,0,0,0,4,0,4,1,1,0,2,1,1,0,0,0,17,11,6,1,1,0,1,1,0,1,1,0
2018,194824,Music Theory and Composition,1,Bachelor's degree,1,0,1,0,0,0,0,0,0,0,0,0,0,0,0,0,0,0,1,0,1,0,0,0,0,0,0,0,0,0
2018,194824,Pre-Medicine/Pre-Medical Studies,1,Bachelor's degree,16,8,8,0,0,0,11,6,5,0,0,0,1,0,1,0,0,0,2,2,0,2,0,2,0,0,0,0,0,0
2018,194824,"Business Administration and Management, General",1,Bachelor's degree,87,56,31,0,0,0,6,4,2,7,4,3,3,3,0,0,0,0,51,31,20,4,2,2,2,2,0,14,10,4
2018,194824,"Business Administration and Management, General",1,Master's degree,22,12,10,0,0,0,2,0,2,1,0,1,1,1,0,0,0,0,12,8,4,1,1,0,0,0,0,5,2,3
2018,194824,"Logistics, Materials, and Supply Chain Management",1,Master's degree,0,0,0,0,0,0,0,0,0,0,0,0,0,0,0,0,0,0,0,0,0,0,0,0,0,0,0,0,0,0
2018,194824,Entrepreneurship/Entrepreneurial Studies,1,Master's degree,14,6,8,0,0,0,2,0,2,0,0,0,2,1,1,0,0,0,7,4,3,1,0,1,0,0,0,2,1,1
2018,194824,"Finance and Financial Management Services, Other",1,Master's degree,0,0,0,0,0,0,0,0,0,0,0,0,0,0,0,0,0,0,0,0,0,0,0,0,0,0,0,0,0,0
2018,194824,Business Statistics,1,Master's degree,39,21,18,0,0,0,4,1,3,0,0,0,0,0,0,0,0,0,7,3,4,2,2,0,0,0,0,26,15,11
2018,194824,"Management Sciences and Quantitative Methods, Other",1,Master's degree,16,10,6,0,0,0,1,1,0,0,0,0,2,2,0,0,0,0,3,3,0,4,2,2,0,0,0,6,2,4
2018,194824,"Business, Management, Marketing, and Related Support Services, Other",1,Master's degree,0,0,0,0,0,0,0,0,0,0,0,0,0,0,0,0,0,0,0,0,0,0,0,0,0,0,0,0,0,0
2018,194824,99,1,Bachelor's degree,1425,953,472,1,1,0,155,96,59,49,30,19,92,62,30,1,1,0,818,556,262,113,67,46,23,20,3,173,120,53
2018,194824,99,1,Master's degree,407,244,163,0,0,0,28,14,14,8,3,5,23,14,9,0,0,0,178,116,62,15,9,6,6,4,2,149,84,65
2024,194824,Environmental Science,1,Bachelor's degree,4,1,3,0,0,0,0,0,0,0,0,0,1,0,1,0,0,0,3,1,2,0,0,0,0,0,0,0,0,0
2024,194824,Architecture,1,Bachelor's degree,52,22,30,0,0,0,10,2,8,2,0,2,6,4,2,0,0,0,28,14,14,3,0,3,1,0,1,2,2,0
2024,194824,Architecture,1,Master's degree,4,2,2,0,0,0,1,0,1,1,0,1,1,1,0,0,0,0,1,1,0,0,0,0,0,0,0,0,0,0
2024,194824,Architectural and Building Sciences/Technology,1,Bachelor's degree,1,0,1,0,0,0,0,0,0,0,0,0,0,0,0,0,0,0,1,0,1,0,0,0,0,0,0,0,0,0
2024,194824,Architectural and Building Sciences/Technology,1,Master's degree,7,5,2,0,0,0,0,0,0,1,1,0,0,0,0,0,0,0,1,1,0,1,1,0,0,0,0,4,2,2
2024,194824,"Communication, General",1,Bachelor's degree,7,2,5,0,0,0,2,0,2,0,0,0,0,0,0,0,0,0,3,0,3,1,1,0,0,0,0,1,1,0
2024,194824,Speech Communication and Rhetoric,1,Bachelor's degree,0,0,0,0,0,0,0,0,0,0,0,0,0,0,0,0,0,0,0,0,0,0,0,0,0,0,0,0,0,0
2024,194824,Speech Communication and Rhetoric,1,Master's degree,1,0,1,0,0,0,0,0,0,0,0,0,0,0,0,0,0,0,1,0,1,0,0,0,0,0,0,0,0,0
2024,194824,Digital Communication and Media/Multimedia,1,Bachelor's degree,1,1,0,0,0,0,0,0,0,1,1,0,0,0,0,0,0,0,0,0,0,0,0,0,0,0,0,0,0,0
2024,194824,Technical and Scientific Communication,1,Master's degree,0,0,0,0,0,0,0,0,0,0,0,0,0,0,0,0,0,0,0,0,0,0,0,0,0,0,0,0,0,0
2024,194824,"Computer and Information Sciences, General",1,Bachelor's degree,0,0,0,0,0,0,0,0,0,0,0,0,0,0,0,0,0,0,0,0,0,0,0,0,0,0,0,0,0,0
2024,194824,"Computer and Information Sciences, General",1,Master's degree,0,0,0,0,0,0,0,0,0,0,0,0,0,0,0,0,0,0,0,0,0,0,0,0,0,0,0,0,0,0
2024,194824,Information Technology,1,Bachelor's degree,23,14,9,0,0,0,7,6,1,1,0,1,4,3,1,0,0,0,7,2,5,2,1,1,0,0,0,2,2,0
2024,194824,Information Technology,1,Master's degree,24,16,8,0,0,0,7,4,3,0,0,0,1,1,0,0,0,0,0,0,0,0,0,0,1,1,0,15,10,5
2024,194824,Computer Science,1,Bachelor's degree,237,201,36,0,0,0,64,49,15,12,12,0,24,18,6,0,0,0,74,66,8,15,14,1,17,13,4,31,29,2
2024,194824,Computer Science,1,Master's degree,17,16,1,0,0,0,5,4,1,0,0,0,0,0,0,0,0,0,9,9,0,0,0,0,2,2,0,1,1,0
2024,194824,"Aerospace, Aeronautical, and Astronautical/Space Engineering, General",1,Bachelor's degree,92,74,18,0,0,0,13,12,1,4,4,0,17,16,1,0,0,0,45,30,15,6,6,0,4,4,0,3,2,1
2024,194824,"Aerospace, Aeronautical, and Astronautical/Space Engineering, General",1,Master's degree,22,15,7,0,0,0,2,2,0,0,0,0,2,1,1,0,0,0,13,10,3,4,1,3,0,0,0,1,1,0
2024,194824,Bioengineering and Biomedical Engineering,1,Bachelor's degree,75,28,47,0,0,0,9,2,7,2,0,2,10,4,6,0,0,0,36,13,23,6,3,3,4,3,1,8,3,5
2024,194824,Bioengineering and Biomedical Engineering,1,Master's degree,17,8,9,0,0,0,2,0,2,0,0,0,1,0,1,0,0,0,9,5,4,1,1,0,1,0,1,3,2,1
2024,194824,Chemical Engineering,1,Bachelor's degree,48,25,23,0,0,0,5,3,2,0,0,0,4,3,1,0,0,0,29,15,14,3,3,0,5,1,4,2,0,2
2024,194824,Chemical Engineering,1,Master's degree,11,9,2,0,0,0,2,2,0,0,0,0,0,0,0,0,0,0,6,4,2,2,2,0,0,0,0,1,1,0
2024,194824,"Civil Engineering, General",1,Bachelor's degree,50,30,20,0,0,0,8,3,5,3,2,1,10,5,5,0,0,0,24,16,8,3,2,1,1,1,0,1,1,0
2024,194824,"Civil Engineering, General",1,Master's degree,18,10,8,0,0,0,2,2,0,1,1,0,0,0,0,0,0,0,11,6,5,0,0,0,0,0,0,4,1,3
2024,194824,Transportation and Highway Engineering,1,Master's degree,1,1,0,0,0,0,0,0,0,1,1,0,0,0,0,0,0,0,0,0,0,0,0,0,0,0,0,0,0,0
2024,194824,Electrical and Electronics Engineering,1,Bachelor's degree,68,58,10,0,0,0,10,8,2,5,3,2,11,9,2,0,0,0,18,16,2,6,6,0,4,3,1,14,13,1
2024,194824,Electrical and Electronics Engineering,1,Master's degree,6,6,0,0,0,0,1,1,0,0,0,0,0,0,0,0,0,0,2,2,0,0,0,0,0,0,0,3,3,0
2024,194824,Engineering Physics/Applied Physics,1,Bachelor's degree,0,0,0,0,0,0,0,0,0,0,0,0,0,0,0,0,0,0,0,0,0,0,0,0,0,0,0,0,0,0
2024,194824,Engineering Physics/Applied Physics,1,Master's degree,0,0,0,0,0,0,0,0,0,0,0,0,0,0,0,0,0,0,0,0,0,0,0,0,0,0,0,0,0,0
2024,194824,Engineering Science,1,Bachelor's degree,0,0,0,0,0,0,0,0,0,0,0,0,0,0,0,0,0,0,0,0,0,0,0,0,0,0,0,0,0,0
2024,194824,Engineering Science,1,Master's degree,5,4,1,0,0,0,0,0,0,0,0,0,0,0,0,0,0,0,3,3,0,0,0,0,2,1,1,0,0,0
2024,194824,Environmental/Environmental Health Engineering,1,Bachelor's degree,10,1,9,0,0,0,1,0,1,0,0,0,1,0,1,0,0,0,5,0,5,0,0,0,1,0,1,2,1,1
2024,194824,Environmental/Environmental Health Engineering,1,Master's degree,7,1,6,0,0,0,0,0,0,0,0,0,0,0,0,0,0,0,5,0,5,0,0,0,1,0,1,1,1,0
2024,194824,Materials Engineering,1,Bachelor's degree,15,10,5,0,0,0,0,0,0,0,0,0,1,1,0,0,0,0,10,7,3,0,0,0,0,0,0,4,2,2
2024,194824,Materials Engineering,1,Master's degree,5,2,3,0,0,0,2,1,1,0,0,0,0,0,0,0,0,0,2,1,1,0,0,0,0,0,0,1,0,1
2024,194824,Mechanical Engineering,1,Bachelor's degree,146,117,29,1,1,0,18,16,2,4,4,0,11,9,2,0,0,0,84,65,19,7,2,5,4,4,0,17,16,1
2024,194824,Mechanical Engineering,1,Master's degree,32,30,2,0,0,0,6,5,1,2,2,0,3,3,0,0,0,0,12,11,1,1,1,0,2,2,0,6,6,0
2024,194824,Nuclear Engineering,1,Bachelor's degree,16,11,5,0,0,0,1,1,0,0,0,0,2,1,1,0,0,0,11,7,4,1,1,0,0,0,0,1,1,0
2024,194824,Nuclear Engineering,1,Master's degree,5,3,2,0,0,0,0,0,0,0,0,0,0,0,0,0,0,0,4,2,2,0,0,0,0,0,0,1,1,0
2024,194824,Systems Engineering,1,Master's degree,23,15,8,0,0,0,4,3,1,0,0,0,1,0,1,0,0,0,12,8,4,2,1,1,4,3,1,0,0,0
2024,194824,Industrial Engineering,1,Bachelor's degree,19,11,8,0,0,0,3,2,1,1,1,0,2,1,1,0,0,0,9,5,4,1,1,0,1,0,1,2,1,1
2024,194824,Industrial Engineering,1,Master's degree,2,2,0,0,0,0,0,0,0,0,0,0,0,0,0,0,0,0,2,2,0,0,0,0,0,0,0,0,0,0
2024,194824,Operations Research,1,Master's degree,0,0,0,0,0,0,0,0,0,0,0,0,0,0,0,0,0,0,0,0,0,0,0,0,0,0,0,0,0,0
2024,194824,Computer/Computer Systems Technology/Technician,1,Bachelor's degree,53,47,6,0,0,0,14,12,2,3,2,1,7,7,0,0,0,0,19,16,3,1,1,0,3,3,0,6,6,0
2024,194824,Computer/Computer Systems Technology/Technician,1,Master's degree,7,5,2,0,0,0,2,2,0,0,0,0,1,0,1,0,0,0,0,0,0,0,0,0,0,0,0,4,3,1
2024,194824,Pre-Law Studies,1,Bachelor's degree,0,0,0,0,0,0,0,0,0,0,0,0,0,0,0,0,0,0,0,0,0,0,0,0,0,0,0,0,0,0
2024,194824,"Biology/Biological Sciences, General",1,Bachelor's degree,17,7,10,0,0,0,1,1,0,0,0,0,2,1,1,0,0,0,13,5,8,0,0,0,0,0,0,1,0,1
2024,194824,"Biology/Biological Sciences, General",1,Master's degree,0,0,0,0,0,0,0,0,0,0,0,0,0,0,0,0,0,0,0,0,0,0,0,0,0,0,0,0,0,0
2024,194824,Biochemistry and Molecular Biology,1,Bachelor's degree,0,0,0,0,0,0,0,0,0,0,0,0,0,0,0,0,0,0,0,0,0,0,0,0,0,0,0,0,0,0
2024,194824,Biochemistry and Molecular Biology,1,Master's degree,0,0,0,0,0,0,0,0,0,0,0,0,0,0,0,0,0,0,0,0,0,0,0,0,0,0,0,0,0,0
2024,194824,"Biochemistry, Biophysics and Molecular Biology, Other",1,Bachelor's degree,20,11,9,0,0,0,3,1,2,2,1,1,1,0,1,0,0,0,12,7,5,1,1,0,1,1,0,0,0,0
2024,194824,"Biochemistry, Biophysics and Molecular Biology, Other",1,Master's degree,4,1,3,0,0,0,0,0,0,1,0,1,0,0,0,0,0,0,3,1,2,0,0,0,0,0,0,0,0,0
2024,194824,Bioinformatics,1,Bachelor's degree,6,3,3,0,0,0,1,0,1,0,0,0,1,1,0,0,0,0,4,2,2,0,0,0,0,0,0,0,0,0
2024,194824,Neuroscience,1,Bachelor's degree,8,3,5,0,0,0,2,0,2,1,0,1,1,1,0,0,0,0,4,2,2,0,0,0,0,0,0,0,0,0
2024,194824,"Mathematics, General",1,Bachelor's degree,54,43,11,0,0,0,7,4,3,1,0,1,3,2,1,0,0,0,11,9,2,3,3,0,2,2,0,27,23,4
2024,194824,"Mathematics, General",1,Master's degree,0,0,0,0,0,0,0,0,0,0,0,0,0,0,0,0,0,0,0,0,0,0,0,0,0,0,0,0,0,0
2024,194824,"Applied Mathematics, General",1,Master's degree,13,7,6,0,0,0,3,1,2,0,0,0,0,0,0,0,0,0,3,1,2,2,2,0,2,1,1,3,2,1
2024,194824,Financial Mathematics,1,Master's degree,20,13,7,0,0,0,1,1,0,1,1,0,0,0,0,0,0,0,8,5,3,3,2,1,0,0,0,7,4,3
2024,194824,"Multi-/Interdisciplinary Studies, General",1,Bachelor's degree,0,0,0,0,0,0,0,0,0,0,0,0,0,0,0,0,0,0,0,0,0,0,0,0,0,0,0,0,0,0
2024,194824,"Multi-/Interdisciplinary Studies, General",1,Master's degree,0,0,0,0,0,0,0,0,0,0,0,0,0,0,0,0,0,0,0,0,0,0,0,0,0,0,0,0,0,0
2024,194824,Biological and Physical Sciences,1,Master's degree,0,0,0,0,0,0,0,0,0,0,0,0,0,0,0,0,0,0,0,0,0,0,0,0,0,0,0,0,0,0
2024,194824,"Science, Technology and Society",1,Bachelor's degree,2,0,2,0,0,0,0,0,0,0,0,0,0,0,0,0,0,0,1,0,1,0,0,0,1,0,1,0,0,0
2024,194824,"Science, Technology and Society",1,Master's degree,0,0,0,0,0,0,0,0,0,0,0,0,0,0,0,0,0,0,0,0,0,0,0,0,0,0,0,0,0,0
2024,194824,Natural Sciences,1,Master's degree,0,0,0,0,0,0,0,0,0,0,0,0,0,0,0,0,0,0,0,0,0,0,0,0,0,0,0,0,0,0
2024,194824,"Cognitive Science, General",1,Bachelor's degree,10,5,5,0,0,0,1,0,1,1,0,1,1,0,1,0,0,0,4,2,2,1,1,0,2,2,0,0,0,0
2024,194824,"Cognitive Science, General",1,Master's degree,6,2,4,0,0,0,1,0,1,0,0,0,1,1,0,0,0,0,4,1,3,0,0,0,0,0,0,0,0,0
2024,194824,Human Computer Interaction,1,Master's degree,0,0,0,0,0,0,0,0,0,0,0,0,0,0,0,0,0,0,0,0,0,0,0,0,0,0,0,0,0,0
2024,194824,Sustainability Studies,1,Bachelor's degree,3,0,3,0,0,0,0,0,0,0,0,0,1,0,1,0,0,0,1,0,1,1,0,1,0,0,0,0,0,0
2024,194824,Business Analytics,1,Bachelor's degree,0,0,0,0,0,0,0,0,0,0,0,0,0,0,0,0,0,0,0,0,0,0,0,0,0,0,0,0,0,0
2024,194824,"Multi-/Interdisciplinary Studies, Other",1,Bachelor's degree,4,2,2,0,0,0,0,0,0,1,1,0,1,0,1,0,0,0,1,0,1,0,0,0,1,1,0,0,0,0
2024,194824,"Multi-/Interdisciplinary Studies, Other",1,Master's degree,0,0,0,0,0,0,0,0,0,0,0,0,0,0,0,0,0,0,0,0,0,0,0,0,0,0,0,0,0,0
2024,194824,Philosophy,1,Bachelor's degree,3,2,1,0,0,0,0,0,0,0,0,0,0,0,0,0,0,0,2,1,1,1,1,0,0,0,0,0,0,0
2024,194824,Philosophy,1,Master's degree,0,0,0,0,0,0,0,0,0,0,0,0,0,0,0,0,0,0,0,0,0,0,0,0,0,0,0,0,0,0
2024,194824,Astronomy,1,Master's degree,2,2,0,0,0,0,0,0,0,0,0,0,0,0,0,0,0,0,1,1,0,0,0,0,0,0,0,1,1,0
2024,194824,"Chemistry, General",1,Bachelor's degree,10,5,5,0,0,0,3,2,1,0,0,0,1,1,0,0,0,0,5,2,3,1,0,1,0,0,0,0,0,0
2024,194824,"Chemistry, General",1,Master's degree,2,2,0,0,0,0,0,0,0,0,0,0,1,1,0,0,0,0,1,1,0,0,0,0,0,0,0,0,0,0
2024,194824,"Geology/Earth Science, General",1,Bachelor's degree,1,0,1,0,0,0,0,0,0,0,0,0,0,0,0,0,0,0,1,0,1,0,0,0,0,0,0,0,0,0
2024,194824,"Geology/Earth Science, General",1,Master's degree,0,0,0,0,0,0,0,0,0,0,0,0,0,0,0,0,0,0,0,0,0,0,0,0,0,0,0,0,0,0
2024,194824,Hydrology and Water Resources Science,1,Bachelor's degree,0,0,0,0,0,0,0,0,0,0,0,0,0,0,0,0,0,0,0,0,0,0,0,0,0,0,0,0,0,0
2024,194824,Hydrology and Water Resources Science,1,Master's degree,0,0,0,0,0,0,0,0,0,0,0,0,0,0,0,0,0,0,0,0,0,0,0,0,0,0,0,0,0,0
2024,194824,"Physics, General",1,Bachelor's degree,32,23,9,0,0,0,5,3,2,1,1,0,5,5,0,0,0,0,14,9,5,0,0,0,3,1,2,4,4,0
2024,194824,"Physics, General",1,Master's degree,3,2,1,0,0,0,1,0,1,0,0,0,0,0,0,0,0,0,1,1,0,0,0,0,0,0,0,1,1,0
2024,194824,"Physics, Other",1,Bachelor's degree,5,2,3,0,0,0,0,0,0,0,0,0,0,0,0,0,0,0,2,1,1,1,0,1,0,0,0,2,1,1
2024,194824,"Psychology, General",1,Bachelor's degree,11,4,7,0,0,0,0,0,0,2,1,1,0,0,0,0,0,0,7,3,4,0,0,0,1,0,1,1,0,1
2024,194824,"Psychology, General",1,Master's degree,0,0,0,0,0,0,0,0,0,0,0,0,0,0,0,0,0,0,0,0,0,0,0,0,0,0,0,0,0,0
2024,194824,"Social Sciences, General",1,Bachelor's degree,0,0,0,0,0,0,0,0,0,0,0,0,0,0,0,0,0,0,0,0,0,0,0,0,0,0,0,0,0,0
2024,194824,"Social Sciences, General",1,Master's degree,0,0,0,0,0,0,0,0,0,0,0,0,0,0,0,0,0,0,0,0,0,0,0,0,0,0,0,0,0,0
2024,194824,"Economics, General",1,Bachelor's degree,0,0,0,0,0,0,0,0,0,0,0,0,0,0,0,0,0,0,0,0,0,0,0,0,0,0,0,0,0,0
2024,194824,"Economics, General",1,Master's degree,0,0,0,0,0,0,0,0,0,0,0,0,0,0,0,0,0,0,0,0,0,0,0,0,0,0,0,0,0,0
2024,194824,Econometrics and Quantitative Economics,1,Bachelor's degree,8,8,0,0,0,0,1,1,0,0,0,0,1,1,0,0,0,0,3,3,0,0,0,0,0,0,0,3,3,0
2024,194824,Econometrics and Quantitative Economics,1,Master's degree,1,0,1,0,0,0,0,0,0,0,0,0,0,0,0,0,0,0,0,0,0,0,0,0,0,0,0,1,0,1
2024,194824,"Economics, Other",1,Master's degree,0,0,0,0,0,0,0,0,0,0,0,0,0,0,0,0,0,0,0,0,0,0,0,0,0,0,0,0,0,0
2024,194824,"Social Sciences, Other",1,Master's degree,0,0,0,0,0,0,0,0,0,0,0,0,0,0,0,0,0,0,0,0,0,0,0,0,0,0,0,0,0,0
2024,194824,"Visual and Performing Arts, General",1,Bachelor's degree,7,2,5,0,0,0,0,0,0,1,0,1,0,0,0,0,0,0,4,2,2,0,0,0,0,0,0,2,0,2
2024,194824,"Visual and Performing Arts, General",1,Master's degree,1,1,0,0,0,0,0,0,0,0,0,0,1,1,0,0,0,0,0,0,0,0,0,0,0,0,0,0,0,0
2024,194824,Game and Interactive Media Design,1,Bachelor's degree,39,31,8,0,0,0,6,3,3,1,1,0,6,5,1,0,0,0,15,11,4,3,3,0,2,2,0,6,6,0
2024,194824,Game and Interactive Media Design,1,Master's degree,6,5,1,0,0,0,0,0,0,0,0,0,0,0,0,0,0,0,3,2,1,0,0,0,0,0,0,3,3,0
2024,194824,Music Theory and Composition,1,Bachelor's degree,2,2,0,0,0,0,0,0,0,0,0,0,1,1,0,0,0,0,1,1,0,0,0,0,0,0,0,0,0,0
2024,194824,Pre-Medicine/Pre-Medical Studies,1,Bachelor's degree,14,6,8,0,0,0,10,3,7,0,0,0,1,1,0,0,0,0,0,0,0,1,0,1,2,2,0,0,0,0
2024,194824,"Business Administration and Management, General",1,Bachelor's degree,60,49,11,0,0,0,10,9,1,7,7,0,3,2,1,0,0,0,23,19,4,5,4,1,0,0,0,12,8,4
2024,194824,"Business Administration and Management, General",1,Master's degree,0,0,0,0,0,0,0,0,0,0,0,0,0,0,0,0,0,0,0,0,0,0,0,0,0,0,0,0,0,0
2024,194824,"Logistics, Materials, and Supply Chain Management",1,Master's degree,0,0,0,0,0,0,0,0,0,0,0,0,0,0,0,0,0,0,0,0,0,0,0,0,0,0,0,0,0,0
2024,194824,"Business Administration, Management and Operations, Other",1,Master's degree,0,0,0,0,0,0,0,0,0,0,0,0,0,0,0,0,0,0,0,0,0,0,0,0,0,0,0,0,0,0
2024,194824,Entrepreneurship/Entrepreneurial Studies,1,Master's degree,0,0,0,0,0,0,0,0,0,0,0,0,0,0,0,0,0,0,0,0,0,0,0,0,0,0,0,0,0,0
2024,194824,"Finance and Financial Management Services, Other",1,Master's degree,0,0,0,0,0,0,0,0,0,0,0,0,0,0,0,0,0,0,0,0,0,0,0,0,0,0,0,0,0,0
2024,194824,Business Statistics,1,Bachelor's degree,14,10,4,0,0,0,4,2,2,2,2,0,0,0,0,0,0,0,3,2,1,0,0,0,0,0,0,5,4,1
2024,194824,Business Statistics,1,Master's degree,25,15,10,0,0,0,1,1,0,1,0,1,0,0,0,0,0,0,9,6,3,3,2,1,0,0,0,11,6,5
2024,194824,"Management Sciences and Quantitative Methods, Other",1,Master's degree,48,28,20,0,0,0,6,2,4,4,2,2,7,5,2,0,0,0,24,13,11,1,1,0,0,0,0,6,5,1
2024,194824,99,1,Bachelor's degree,1247,871,376,1,1,0,219,145,74,58,43,15,140,102,38,0,0,0,537,354,183,73,54,19,60,43,17,159,129,30
2024,194824,99,1,Master's degree,345,228,117,0,0,0,49,31,18,13,8,5,20,14,6,0,0,0,150,97,53,20,14,6,15,10,5,78,54,24
2015,194824,Environmental Science,1,Bachelor's degree,1,0,1,0,0,0,0,0,0,0,0,0,0,0,0,0,0,0,1,0,1,0,0,0,0,0,0,0,0,0
2015,194824,Architecture,1,Bachelor's degree,45,19,26,0,0,0,6,4,2,1,1,0,3,0,3,0,0,0,28,13,15,2,0,2,1,0,1,4,1,3
2015,194824,Architecture,1,Master's degree,10,6,4,0,0,0,1,1,0,0,0,0,0,0,0,0,0,0,5,3,2,0,0,0,1,1,0,3,1,2
2015,194824,Architectural and Building Sciences/Technology,1,Bachelor's degree,0,0,0,0,0,0,0,0,0,0,0,0,0,0,0,0,0,0,0,0,0,0,0,0,0,0,0,0,0,0
2015,194824,Architectural and Building Sciences/Technology,1,Master's degree,10,7,3,0,0,0,1,1,0,0,0,0,0,0,0,0,0,0,7,5,2,1,0,1,1,1,0,0,0,0
2015,194824,"Architecture and Related Services, Other",1,Bachelor's degree,0,0,0,0,0,0,0,0,0,0,0,0,0,0,0,0,0,0,0,0,0,0,0,0,0,0,0,0,0,0
2015,194824,"Architecture and Related Services, Other",1,Master's degree,5,2,3,0,0,0,0,0,0,0,0,0,1,0,1,0,0,0,2,1,1,0,0,0,0,0,0,2,1,1
2015,194824,"Communication, General",1,Bachelor's degree,4,0,4,0,0,0,0,0,0,0,0,0,0,0,0,0,0,0,4,0,4,0,0,0,0,0,0,0,0,0
2015,194824,Speech Communication and Rhetoric,1,Bachelor's degree,0,0,0,0,0,0,0,0,0,0,0,0,0,0,0,0,0,0,0,0,0,0,0,0,0,0,0,0,0,0
2015,194824,Speech Communication and Rhetoric,1,Master's degree,3,0,3,0,0,0,0,0,0,0,0,0,0,0,0,0,0,0,3,0,3,0,0,0,0,0,0,0,0,0
2015,194824,Digital Communication and Media/Multimedia,1,Bachelor's degree,17,6,11,0,0,0,2,0,2,0,0,0,1,0,1,0,0,0,11,6,5,0,0,0,0,0,0,3,0,3
2015,194824,Technical and Scientific Communication,1,Master's degree,1,0,1,0,0,0,0,0,0,0,0,0,0,0,0,0,0,0,1,0,1,0,0,0,0,0,0,0,0,0
2015,194824,"Computer and Information Sciences, General",1,Bachelor's degree,0,0,0,0,0,0,0,0,0,0,0,0,0,0,0,0,0,0,0,0,0,0,0,0,0,0,0,0,0,0
2015,194824,"Computer and Information Sciences, General",1,Master's degree,0,0,0,0,0,0,0,0,0,0,0,0,0,0,0,0,0,0,0,0,0,0,0,0,0,0,0,0,0,0
2015,194824,Information Technology,1,Bachelor's degree,13,6,7,0,0,0,2,1,1,1,0,1,1,0,1,0,0,0,4,1,3,3,2,1,0,0,0,2,2,0
2015,194824,Information Technology,1,Master's degree,34,25,9,0,0,0,2,2,0,2,1,1,1,1,0,0,0,0,7,5,2,0,0,0,1,1,0,21,15,6
2015,194824,Computer Science,1,Bachelor's degree,101,88,13,0,0,0,16,14,2,1,1,0,4,4,0,0,0,0,60,53,7,12,10,2,1,1,0,7,5,2
2015,194824,Computer Science,1,Master's degree,24,18,6,0,0,0,3,3,0,1,0,1,1,1,0,0,0,0,15,12,3,0,0,0,0,0,0,4,2,2
2015,194824,"Aerospace, Aeronautical, and Astronautical/Space Engineering, General",1,Bachelor's degree,70,59,11,0,0,0,3,3,0,0,0,0,3,3,0,0,0,0,60,50,10,4,3,1,0,0,0,0,0,0
2015,194824,"Aerospace, Aeronautical, and Astronautical/Space Engineering, General",1,Master's degree,10,9,1,0,0,0,1,1,0,0,0,0,0,0,0,0,0,0,7,6,1,2,2,0,0,0,0,0,0,0
2015,194824,Bioengineering and Biomedical Engineering,1,Bachelor's degree,72,32,40,0,0,0,7,5,2,1,0,1,4,1,3,0,0,0,47,21,26,9,5,4,0,0,0,4,0,4
2015,194824,Bioengineering and Biomedical Engineering,1,Master's degree,16,6,10,0,0,0,1,1,0,0,0,0,0,0,0,0,0,0,13,5,8,1,0,1,0,0,0,1,0,1
2015,194824,Chemical Engineering,1,Bachelor's degree,74,53,21,0,0,0,7,5,2,2,1,1,5,3,2,0,0,0,52,39,13,3,1,2,0,0,0,5,4,1
2015,194824,Chemical Engineering,1,Master's degree,1,1,0,0,0,0,0,0,0,0,0,0,0,0,0,0,0,0,1,1,0,0,0,0,0,0,0,0,0,0
2015,194824,"Civil Engineering, General",1,Bachelor's degree,60,41,19,0,0,0,4,2,2,2,2,0,4,3,1,0,0,0,45,29,16,0,0,0,0,0,0,5,5,0
2015,194824,"Civil Engineering, General",1,Master's degree,22,12,10,0,0,0,3,1,2,0,0,0,0,0,0,0,0,0,14,8,6,0,0,0,0,0,0,5,3,2
2015,194824,Transportation and Highway Engineering,1,Master's degree,1,1,0,0,0,0,0,0,0,0,0,0,1,1,0,0,0,0,0,0,0,0,0,0,0,0,0,0,0,0
2015,194824,Electrical and Electronics Engineering,1,Bachelor's degree,84,74,10,0,0,0,11,10,1,3,2,1,5,3,2,0,0,0,48,45,3,3,2,1,1,1,0,13,11,2
2015,194824,Electrical and Electronics Engineering,1,Master's degree,17,15,2,0,0,0,0,0,0,1,1,0,0,0,0,0,0,0,7,6,1,1,1,0,0,0,0,8,7,1
2015,194824,Engineering Physics/Applied Physics,1,Bachelor's degree,0,0,0,0,0,0,0,0,0,0,0,0,0,0,0,0,0,0,0,0,0,0,0,0,0,0,0,0,0,0
2015,194824,Engineering Physics/Applied Physics,1,Master's degree,0,0,0,0,0,0,0,0,0,0,0,0,0,0,0,0,0,0,0,0,0,0,0,0,0,0,0,0,0,0
2015,194824,Engineering Science,1,Bachelor's degree,0,0,0,0,0,0,0,0,0,0,0,0,0,0,0,0,0,0,0,0,0,0,0,0,0,0,0,0,0,0
2015,194824,Engineering Science,1,Master's degree,0,0,0,0,0,0,0,0,0,0,0,0,0,0,0,0,0,0,0,0,0,0,0,0,0,0,0,0,0,0
2015,194824,Environmental/Environmental Health Engineering,1,Bachelor's degree,7,4,3,0,0,0,0,0,0,0,0,0,1,0,1,0,0,0,5,4,1,0,0,0,0,0,0,1,0,1
2015,194824,Environmental/Environmental Health Engineering,1,Master's degree,4,3,1,0,0,0,0,0,0,0,0,0,1,0,1,0,0,0,3,3,0,0,0,0,0,0,0,0,0,0
2015,194824,Materials Engineering,1,Bachelor's degree,26,16,10,0,0,0,0,0,0,0,0,0,2,1,1,0,0,0,18,13,5,2,1,1,1,0,1,3,1,2
2015,194824,Materials Engineering,1,Master's degree,3,0,3,0,0,0,0,0,0,0,0,0,0,0,0,0,0,0,3,0,3,0,0,0,0,0,0,0,0,0
2015,194824,Mechanical Engineering,1,Bachelor's degree,169,140,29,0,0,0,12,10,2,6,4,2,6,4,2,0,0,0,122,105,17,11,7,4,3,3,0,9,7,2
2015,194824,Mechanical Engineering,1,Master's degree,25,20,5,0,0,0,4,2,2,2,1,1,0,0,0,0,0,0,14,13,1,0,0,0,0,0,0,5,4,1
2015,194824,Nuclear Engineering,1,Bachelor's degree,19,13,6,0,0,0,0,0,0,1,1,0,2,1,1,0,0,0,16,11,5,0,0,0,0,0,0,0,0,0
2015,194824,Nuclear Engineering,1,Master's degree,1,1,0,0,0,0,0,0,0,0,0,0,0,0,0,0,0,0,1,1,0,0,0,0,0,0,0,0,0,0
2015,194824,Systems Engineering,1,Master's degree,3,3,0,0,0,0,0,0,0,0,0,0,0,0,0,0,0,0,3,3,0,0,0,0,0,0,0,0,0,0
2015,194824,Industrial Engineering,1,Bachelor's degree,58,39,19,0,0,0,2,2,0,2,1,1,3,2,1,0,0,0,42,28,14,5,2,3,1,1,0,3,3,0
2015,194824,Industrial Engineering,1,Master's degree,5,3,2,0,0,0,0,0,0,0,0,0,1,1,0,0,0,0,3,2,1,1,0,1,0,0,0,0,0,0
2015,194824,Operations Research,1,Master's degree,0,0,0,0,0,0,0,0,0,0,0,0,0,0,0,0,0,0,0,0,0,0,0,0,0,0,0,0,0,0
2015,194824,Computer/Computer Systems Technology/Technician,1,Bachelor's degree,31,28,3,0,0,0,5,5,0,0,0,0,1,0,1,0,0,0,23,21,2,0,0,0,1,1,0,1,1,0
2015,194824,Computer/Computer Systems Technology/Technician,1,Master's degree,4,4,0,0,0,0,0,0,0,0,0,0,0,0,0,0,0,0,3,3,0,0,0,0,0,0,0,1,1,0
2015,194824,Pre-Law Studies,1,Bachelor's degree,0,0,0,0,0,0,0,0,0,0,0,0,0,0,0,0,0,0,0,0,0,0,0,0,0,0,0,0,0,0
2015,194824,"Biology/Biological Sciences, General",1,Bachelor's degree,33,10,23,0,0,0,8,3,5,0,0,0,2,1,1,0,0,0,19,5,14,4,1,3,0,0,0,0,0,0
2015,194824,"Biology/Biological Sciences, General",1,Master's degree,3,2,1,0,0,0,0,0,0,0,0,0,0,0,0,0,0,0,3,2,1,0,0,0,0,0,0,0,0,0
2015,194824,Biochemistry and Molecular Biology,1,Bachelor's degree,0,0,0,0,0,0,0,0,0,0,0,0,0,0,0,0,0,0,0,0,0,0,0,0,0,0,0,0,0,0
2015,194824,Biochemistry and Molecular Biology,1,Master's degree,0,0,0,0,0,0,0,0,0,0,0,0,0,0,0,0,0,0,0,0,0,0,0,0,0,0,0,0,0,0
2015,194824,"Biochemistry, Biophysics and Molecular Biology, Other",1,Bachelor's degree,23,8,15,0,0,0,1,1,0,0,0,0,2,1,1,0,0,0,18,5,13,1,0,1,0,0,0,1,1,0
2015,194824,"Biochemistry, Biophysics and Molecular Biology, Other",1,Master's degree,1,1,0,0,0,0,0,0,0,0,0,0,0,0,0,0,0,0,1,1,0,0,0,0,0,0,0,0,0,0
2015,194824,Bioinformatics,1,Bachelor's degree,7,2,5,0,0,0,1,1,0,0,0,0,0,0,0,0,0,0,5,1,4,1,0,1,0,0,0,0,0,0
2015,194824,"Biological and Biomedical Sciences, Other",1,Bachelor's degree,0,0,0,0,0,0,0,0,0,0,0,0,0,0,0,0,0,0,0,0,0,0,0,0,0,0,0,0,0,0
2015,194824,"Mathematics, General",1,Bachelor's degree,37,26,11,0,0,0,1,1,0,0,0,0,1,1,0,0,0,0,29,21,8,0,0,0,2,2,0,4,1,3
2015,194824,"Mathematics, General",1,Master's degree,2,2,0,0,0,0,0,0,0,0,0,0,0,0,0,0,0,0,2,2,0,0,0,0,0,0,0,0,0,0
2015,194824,"Applied Mathematics, General",1,Master's degree,28,20,8,0,0,0,0,0,0,0,0,0,0,0,0,0,0,0,20,13,7,0,0,0,0,0,0,8,7,1
2015,194824,Financial Mathematics,1,Master's degree,56,29,27,0,0,0,0,0,0,0,0,0,0,0,0,0,0,0,9,7,2,1,0,1,0,0,0,46,22,24
2015,194824,"Multi-/Interdisciplinary Studies, General",1,Bachelor's degree,3,2,1,0,0,0,0,0,0,0,0,0,0,0,0,0,0,0,3,2,1,0,0,0,0,0,0,0,0,0
2015,194824,"Multi-/Interdisciplinary Studies, General",1,Master's degree,2,2,0,0,0,0,0,0,0,0,0,0,0,0,0,0,0,0,1,1,0,0,0,0,0,0,0,1,1,0
2015,194824,"Science, Technology and Society",1,Bachelor's degree,0,0,0,0,0,0,0,0,0,0,0,0,0,0,0,0,0,0,0,0,0,0,0,0,0,0,0,0,0,0
2015,194824,"Science, Technology and Society",1,Master's degree,12,8,4,0,0,0,0,0,0,1,1,0,1,1,0,0,0,0,10,6,4,0,0,0,0,0,0,0,0,0
2015,194824,Natural Sciences,1,Master's degree,0,0,0,0,0,0,0,0,0,0,0,0,0,0,0,0,0,0,0,0,0,0,0,0,0,0,0,0,0,0
2015,194824,"Cognitive Science, General",1,Bachelor's degree,3,0,3,0,0,0,0,0,0,0,0,0,1,0,1,0,0,0,2,0,2,0,0,0,0,0,0,0,0,0
2015,194824,"Cognitive Science, General",1,Master's degree,6,4,2,0,0,0,0,0,0,0,0,0,0,0,0,0,0,0,5,3,2,0,0,0,1,1,0,0,0,0
2015,194824,Human Computer Interaction,1,Master's degree,3,0,3,0,0,0,0,0,0,0,0,0,0,0,0,0,0,0,2,0,2,0,0,0,0,0,0,1,0,1
2015,194824,Sustainability Studies,1,Bachelor's degree,2,0,2,0,0,0,0,0,0,0,0,0,0,0,0,0,0,0,2,0,2,0,0,0,0,0,0,0,0,0
2015,194824,"Multi-/Interdisciplinary Studies, Other",1,Bachelor's degree,5,3,2,0,0,0,0,0,0,0,0,0,0,0,0,0,0,0,4,2,2,0,0,0,0,0,0,1,1,0
2015,194824,"Multi-/Interdisciplinary Studies, Other",1,Master's degree,0,0,0,0,0,0,0,0,0,0,0,0,0,0,0,0,0,0,0,0,0,0,0,0,0,0,0,0,0,0
2015,194824,Philosophy,1,Bachelor's degree,0,0,0,0,0,0,0,0,0,0,0,0,0,0,0,0,0,0,0,0,0,0,0,0,0,0,0,0,0,0
2015,194824,Philosophy,1,Master's degree,0,0,0,0,0,0,0,0,0,0,0,0,0,0,0,0,0,0,0,0,0,0,0,0,0,0,0,0,0,0
2015,194824,Astronomy,1,Master's degree,0,0,0,0,0,0,0,0,0,0,0,0,0,0,0,0,0,0,0,0,0,0,0,0,0,0,0,0,0,0
2015,194824,"Chemistry, General",1,Bachelor's degree,10,8,2,0,0,0,0,0,0,0,0,0,0,0,0,0,0,0,10,8,2,0,0,0,0,0,0,0,0,0
2015,194824,"Chemistry, General",1,Master's degree,3,1,2,0,0,0,0,0,0,0,0,0,0,0,0,0,0,0,2,1,1,0,0,0,0,0,0,1,0,1
2015,194824,"Geology/Earth Science, General",1,Bachelor's degree,2,2,0,0,0,0,0,0,0,0,0,0,0,0,0,0,0,0,2,2,0,0,0,0,0,0,0,0,0,0
2015,194824,"Geology/Earth Science, General",1,Master's degree,1,1,0,0,0,0,0,0,0,0,0,0,0,0,0,0,0,0,1,1,0,0,0,0,0,0,0,0,0,0
2015,194824,Hydrology and Water Resources Science,1,Bachelor's degree,0,0,0,0,0,0,0,0,0,0,0,0,0,0,0,0,0,0,0,0,0,0,0,0,0,0,0,0,0,0
2015,194824,Hydrology and Water Resources Science,1,Master's degree,0,0,0,0,0,0,0,0,0,0,0,0,0,0,0,0,0,0,0,0,0,0,0,0,0,0,0,0,0,0
2015,194824,"Physics, General",1,Bachelor's degree,33,30,3,0,0,0,1,1,0,0,0,0,1,1,0,0,0,0,28,25,3,0,0,0,1,1,0,2,2,0
2015,194824,"Physics, General",1,Master's degree,8,8,0,0,0,0,0,0,0,0,0,0,0,0,0,0,0,0,7,7,0,0,0,0,0,0,0,1,1,0
2015,194824,"Physics, Other",1,Bachelor's degree,8,7,1,0,0,0,0,0,0,0,0,0,0,0,0,0,0,0,7,6,1,0,0,0,1,1,0,0,0,0
2015,194824,"Physical Sciences, Other",1,Bachelor's degree,0,0,0,0,0,0,0,0,0,0,0,0,0,0,0,0,0,0,0,0,0,0,0,0,0,0,0,0,0,0
2015,194824,"Physical Sciences, Other",1,Master's degree,0,0,0,0,0,0,0,0,0,0,0,0,0,0,0,0,0,0,0,0,0,0,0,0,0,0,0,0,0,0
2015,194824,"Psychology, General",1,Bachelor's degree,7,1,6,0,0,0,0,0,0,0,0,0,3,0,3,0,0,0,4,1,3,0,0,0,0,0,0,0,0,0
2015,194824,"Psychology, General",1,Master's degree,0,0,0,0,0,0,0,0,0,0,0,0,0,0,0,0,0,0,0,0,0,0,0,0,0,0,0,0,0,0
2015,194824,"Social Sciences, General",1,Bachelor's degree,0,0,0,0,0,0,0,0,0,0,0,0,0,0,0,0,0,0,0,0,0,0,0,0,0,0,0,0,0,0
2015,194824,"Social Sciences, General",1,Master's degree,0,0,0,0,0,0,0,0,0,0,0,0,0,0,0,0,0,0,0,0,0,0,0,0,0,0,0,0,0,0
2015,194824,"Economics, General",1,Bachelor's degree,5,5,0,0,0,0,1,1,0,0,0,0,1,1,0,0,0,0,3,3,0,0,0,0,0,0,0,0,0,0
2015,194824,"Economics, General",1,Master's degree,0,0,0,0,0,0,0,0,0,0,0,0,0,0,0,0,0,0,0,0,0,0,0,0,0,0,0,0,0,0
2015,194824,"Economics, Other",1,Master's degree,2,1,1,0,0,0,0,0,0,0,0,0,0,0,0,0,0,0,1,0,1,0,0,0,0,0,0,1,1,0
2015,194824,"Social Sciences, Other",1,Master's degree,0,0,0,0,0,0,0,0,0,0,0,0,0,0,0,0,0,0,0,0,0,0,0,0,0,0,0,0,0,0
2015,194824,"Visual and Performing Arts, General",1,Bachelor's degree,4,1,3,0,0,0,0,0,0,0,0,0,0,0,0,0,0,0,2,1,1,1,0,1,1,0,1,0,0,0
2015,194824,"Visual and Performing Arts, General",1,Master's degree,2,1,1,0,0,0,0,0,0,0,0,0,0,0,0,0,0,0,1,1,0,0,0,0,0,0,0,1,0,1
2015,194824,Game and Interactive Media Design,1,Bachelor's degree,19,18,1,0,0,0,4,4,0,2,2,0,1,1,0,0,0,0,10,9,1,2,2,0,0,0,0,0,0,0
2015,194824,Pre-Medicine/Pre-Medical Studies,1,Bachelor's degree,10,3,7,0,0,0,4,2,2,0,0,0,0,0,0,0,0,0,1,0,1,5,1,4,0,0,0,0,0,0
2015,194824,"Business Administration and Management, General",1,Bachelor's degree,81,55,26,0,0,0,7,6,1,3,2,1,2,1,1,1,1,0,48,34,14,2,1,1,3,1,2,15,9,6
2015,194824,"Business Administration and Management, General",1,Master's degree,42,22,20,0,0,0,1,1,0,1,0,1,0,0,0,0,0,0,11,8,3,2,1,1,0,0,0,27,12,15
2015,194824,"Logistics, Materials, and Supply Chain Management",1,Master's degree,5,2,3,0,0,0,1,1,0,0,0,0,1,0,1,0,0,0,3,1,2,0,0,0,0,0,0,0,0,0
2015,194824,Entrepreneurship/Entrepreneurial Studies,1,Master's degree,9,6,3,0,0,0,0,0,0,0,0,0,0,0,0,0,0,0,7,5,2,0,0,0,0,0,0,2,1,1
2015,194824,"Finance and Financial Management Services, Other",1,Master's degree,0,0,0,0,0,0,0,0,0,0,0,0,0,0,0,0,0,0,0,0,0,0,0,0,0,0,0,0,0,0
2015,194824,Business Statistics,1,Master's degree,24,13,11,0,0,0,1,1,0,0,0,0,0,0,0,0,0,0,5,5,0,2,2,0,0,0,0,16,5,11
2015,194824,"Business, Management, Marketing, and Related Support Services, Other",1,Master's degree,0,0,0,0,0,0,0,0,0,0,0,0,0,0,0,0,0,0,0,0,0,0,0,0,0,0,0,0,0,0
2015,194824,99,1,Bachelor's degree,1143,799,344,0,0,0,105,81,24,25,17,8,59,32,27,1,1,0,783,564,219,70,38,32,17,12,5,83,54,29
2015,194824,99,1,Master's degree,408,259,149,0,0,0,19,15,4,8,4,4,8,5,3,0,0,0,203,141,62,11,6,5,4,4,0,155,84,71
2014,194824,Environmental Science,1,Bachelor's degree,2,1,1,0,0,0,0,0,0,0,0,0,0,0,0,0,0,0,2,1,1,0,0,0,0,0,0,0,0,0
2014,194824,Architecture,1,Bachelor's degree,45,18,27,0,0,0,4,1,3,1,0,1,1,1,0,0,0,0,34,14,20,2,0,2,1,1,0,2,1,1
2014,194824,Architecture,1,Master's degree,27,15,12,0,0,0,0,0,0,1,1,0,1,0,1,0,0,0,11,4,7,0,0,0,0,0,0,14,10,4
2014,194824,Architectural and Building Sciences/Technology,1,Bachelor's degree,0,0,0,0,0,0,0,0,0,0,0,0,0,0,0,0,0,0,0,0,0,0,0,0,0,0,0,0,0,0
2014,194824,Architectural and Building Sciences/Technology,1,Master's degree,15,9,6,0,0,0,0,0,0,0,0,0,2,1,1,0,0,0,9,5,4,0,0,0,0,0,0,4,3,1
2014,194824,"Architecture and Related Services, Other",1,Bachelor's degree,0,0,0,0,0,0,0,0,0,0,0,0,0,0,0,0,0,0,0,0,0,0,0,0,0,0,0,0,0,0
2014,194824,"Architecture and Related Services, Other",1,Master's degree,3,1,2,0,0,0,0,0,0,0,0,0,0,0,0,0,0,0,0,0,0,0,0,0,0,0,0,3,1,2
2014,194824,"Communication, General",1,Bachelor's degree,3,0,3,0,0,0,0,0,0,0,0,0,0,0,0,0,0,0,2,0,2,1,0,1,0,0,0,0,0,0
2014,194824,Speech Communication and Rhetoric,1,Bachelor's degree,0,0,0,0,0,0,0,0,0,0,0,0,0,0,0,0,0,0,0,0,0,0,0,0,0,0,0,0,0,0
2014,194824,Speech Communication and Rhetoric,1,Master's degree,2,1,1,0,0,0,0,0,0,0,0,0,0,0,0,0,0,0,2,1,1,0,0,0,0,0,0,0,0,0
2014,194824,Digital Communication and Media/Multimedia,1,Bachelor's degree,21,12,9,0,0,0,1,0,1,0,0,0,1,1,0,0,0,0,18,10,8,1,1,0,0,0,0,0,0,0
2014,194824,Technical and Scientific Communication,1,Master's degree,0,0,0,0,0,0,0,0,0,0,0,0,0,0,0,0,0,0,0,0,0,0,0,0,0,0,0,0,0,0
2014,194824,"Computer and Information Sciences, General",1,Bachelor's degree,0,0,0,0,0,0,0,0,0,0,0,0,0,0,0,0,0,0,0,0,0,0,0,0,0,0,0,0,0,0
2014,194824,"Computer and Information Sciences, General",1,Master's degree,0,0,0,0,0,0,0,0,0,0,0,0,0,0,0,0,0,0,0,0,0,0,0,0,0,0,0,0,0,0
2014,194824,Information Technology,1,Bachelor's degree,21,16,5,0,0,0,1,0,1,0,0,0,1,1,0,0,0,0,16,13,3,1,1,0,1,1,0,1,0,1
2014,194824,Information Technology,1,Master's degree,30,20,10,0,0,0,0,0,0,0,0,0,0,0,0,0,0,0,4,3,1,0,0,0,1,1,0,25,16,9
2014,194824,Computer Science,1,Bachelor's degree,98,91,7,0,0,0,8,6,2,0,0,0,5,4,1,0,0,0,71,68,3,9,9,0,1,1,0,4,3,1
2014,194824,Computer Science,1,Master's degree,15,11,4,0,0,0,0,0,0,1,1,0,2,1,1,0,0,0,6,6,0,0,0,0,0,0,0,6,3,3
2014,194824,"Aerospace, Aeronautical, and Astronautical/Space Engineering, General",1,Bachelor's degree,61,51,10,0,0,0,5,4,1,3,3,0,4,3,1,0,0,0,47,40,7,2,1,1,0,0,0,0,0,0
2014,194824,"Aerospace, Aeronautical, and Astronautical/Space Engineering, General",1,Master's degree,7,7,0,0,0,0,0,0,0,0,0,0,0,0,0,0,0,0,7,7,0,0,0,0,0,0,0,0,0,0
2014,194824,Bioengineering and Biomedical Engineering,1,Bachelor's degree,76,33,43,0,0,0,12,7,5,1,1,0,5,2,3,0,0,0,53,20,33,3,2,1,0,0,0,2,1,1
2014,194824,Bioengineering and Biomedical Engineering,1,Master's degree,15,7,8,0,0,0,3,1,2,0,0,0,0,0,0,0,0,0,11,6,5,0,0,0,0,0,0,1,0,1
2014,194824,Chemical Engineering,1,Bachelor's degree,66,41,25,1,0,1,7,6,1,2,0,2,3,0,3,0,0,0,50,32,18,1,1,0,1,1,0,1,1,0
2014,194824,Chemical Engineering,1,Master's degree,3,2,1,0,0,0,1,1,0,0,0,0,0,0,0,0,0,0,2,1,1,0,0,0,0,0,0,0,0,0
2014,194824,"Civil Engineering, General",1,Bachelor's degree,54,43,11,0,0,0,1,0,1,1,0,1,5,4,1,0,0,0,38,32,6,1,0,1,3,3,0,5,4,1
2014,194824,"Civil Engineering, General",1,Master's degree,15,11,4,0,0,0,1,0,1,0,0,0,1,1,0,0,0,0,9,7,2,0,0,0,0,0,0,4,3,1
2014,194824,Transportation and Highway Engineering,1,Master's degree,2,2,0,0,0,0,0,0,0,0,0,0,0,0,0,0,0,0,2,2,0,0,0,0,0,0,0,0,0,0
2014,194824,Electrical and Electronics Engineering,1,Bachelor's degree,70,55,15,0,0,0,6,6,0,1,0,1,0,0,0,0,0,0,50,39,11,2,1,1,4,4,0,7,5,2
2014,194824,Electrical and Electronics Engineering,1,Master's degree,24,19,5,0,0,0,2,2,0,0,0,0,1,1,0,0,0,0,8,6,2,1,1,0,0,0,0,12,9,3
2014,194824,Engineering Physics/Applied Physics,1,Bachelor's degree,0,0,0,0,0,0,0,0,0,0,0,0,0,0,0,0,0,0,0,0,0,0,0,0,0,0,0,0,0,0
2014,194824,Engineering Physics/Applied Physics,1,Master's degree,0,0,0,0,0,0,0,0,0,0,0,0,0,0,0,0,0,0,0,0,0,0,0,0,0,0,0,0,0,0
2014,194824,Engineering Science,1,Bachelor's degree,0,0,0,0,0,0,0,0,0,0,0,0,0,0,0,0,0,0,0,0,0,0,0,0,0,0,0,0,0,0
2014,194824,Engineering Science,1,Master's degree,0,0,0,0,0,0,0,0,0,0,0,0,0,0,0,0,0,0,0,0,0,0,0,0,0,0,0,0,0,0
2014,194824,Environmental/Environmental Health Engineering,1,Bachelor's degree,16,7,9,0,0,0,0,0,0,1,0,1,1,1,0,0,0,0,11,6,5,0,0,0,2,0,2,1,0,1
2014,194824,Environmental/Environmental Health Engineering,1,Master's degree,6,2,4,0,0,0,0,0,0,0,0,0,1,0,1,0,0,0,5,2,3,0,0,0,0,0,0,0,0,0
2014,194824,Materials Engineering,1,Bachelor's degree,24,19,5,0,0,0,2,0,2,0,0,0,1,1,0,0,0,0,19,16,3,1,1,0,1,1,0,0,0,0
2014,194824,Materials Engineering,1,Master's degree,7,4,3,0,0,0,1,0,1,0,0,0,0,0,0,0,0,0,5,4,1,0,0,0,0,0,0,1,0,1
2014,194824,Mechanical Engineering,1,Bachelor's degree,170,145,25,0,0,0,8,8,0,1,1,0,8,8,0,1,0,1,132,109,23,10,9,1,4,4,0,6,6,0
2014,194824,Mechanical Engineering,1,Master's degree,18,18,0,0,0,0,0,0,0,0,0,0,0,0,0,0,0,0,16,16,0,0,0,0,0,0,0,2,2,0
2014,194824,Nuclear Engineering,1,Bachelor's degree,18,13,5,1,0,1,0,0,0,1,1,0,0,0,0,0,0,0,13,11,2,1,1,0,1,0,1,1,0,1
2014,194824,Nuclear Engineering,1,Master's degree,2,2,0,0,0,0,0,0,0,0,0,0,0,0,0,0,0,0,2,2,0,0,0,0,0,0,0,0,0,0
2014,194824,Systems Engineering,1,Master's degree,1,0,1,0,0,0,0,0,0,0,0,0,0,0,0,0,0,0,1,0,1,0,0,0,0,0,0,0,0,0
2014,194824,Industrial Engineering,1,Bachelor's degree,40,23,17,0,0,0,3,2,1,3,1,2,2,2,0,0,0,0,24,12,12,3,3,0,2,1,1,3,2,1
2014,194824,Industrial Engineering,1,Master's degree,3,3,0,0,0,0,0,0,0,0,0,0,0,0,0,0,0,0,1,1,0,0,0,0,0,0,0,2,2,0
2014,194824,Operations Research,1,Master's degree,0,0,0,0,0,0,0,0,0,0,0,0,0,0,0,0,0,0,0,0,0,0,0,0,0,0,0,0,0,0
2014,194824,Computer/Computer Systems Technology/Technician,1,Bachelor's degree,35,31,4,0,0,0,3,3,0,2,2,0,1,1,0,0,0,0,24,21,3,0,0,0,1,1,0,4,3,1
2014,194824,Computer/Computer Systems Technology/Technician,1,Master's degree,4,2,2,0,0,0,0,0,0,0,0,0,0,0,0,0,0,0,3,2,1,0,0,0,0,0,0,1,0,1
2014,194824,Pre-Law Studies,1,Bachelor's degree,0,0,0,0,0,0,0,0,0,0,0,0,0,0,0,0,0,0,0,0,0,0,0,0,0,0,0,0,0,0
2014,194824,"Biology/Biological Sciences, General",1,Bachelor's degree,36,10,26,0,0,0,7,4,3,1,0,1,2,1,1,0,0,0,21,3,18,5,2,3,0,0,0,0,0,0
2014,194824,"Biology/Biological Sciences, General",1,Master's degree,5,1,4,0,0,0,0,0,0,0,0,0,1,0,1,0,0,0,4,1,3,0,0,0,0,0,0,0,0,0
2014,194824,Biochemistry and Molecular Biology,1,Bachelor's degree,0,0,0,0,0,0,0,0,0,0,0,0,0,0,0,0,0,0,0,0,0,0,0,0,0,0,0,0,0,0
2014,194824,Biochemistry and Molecular Biology,1,Master's degree,0,0,0,0,0,0,0,0,0,0,0,0,0,0,0,0,0,0,0,0,0,0,0,0,0,0,0,0,0,0
2014,194824,"Biochemistry, Biophysics and Molecular Biology, Other",1,Bachelor's degree,26,14,12,0,0,0,3,3,0,0,0,0,1,0,1,0,0,0,19,10,9,2,1,1,0,0,0,1,0,1
2014,194824,"Biochemistry, Biophysics and Molecular Biology, Other",1,Master's degree,0,0,0,0,0,0,0,0,0,0,0,0,0,0,0,0,0,0,0,0,0,0,0,0,0,0,0,0,0,0
2014,194824,Bioinformatics,1,Bachelor's degree,3,2,1,0,0,0,0,0,0,0,0,0,0,0,0,0,0,0,2,2,0,1,0,1,0,0,0,0,0,0
2014,194824,"Biological and Biomedical Sciences, Other",1,Bachelor's degree,0,0,0,0,0,0,0,0,0,0,0,0,0,0,0,0,0,0,0,0,0,0,0,0,0,0,0,0,0,0
2014,194824,"Mathematics, General",1,Bachelor's degree,43,28,15,0,0,0,0,0,0,0,0,0,2,1,1,0,0,0,32,21,11,5,3,2,1,1,0,3,2,1
2014,194824,"Mathematics, General",1,Master's degree,2,1,1,0,0,0,0,0,0,0,0,0,0,0,0,0,0,0,1,1,0,0,0,0,0,0,0,1,0,1
2014,194824,"Applied Mathematics, General",1,Master's degree,12,8,4,0,0,0,0,0,0,0,0,0,1,1,0,0,0,0,10,6,4,0,0,0,1,1,0,0,0,0
2014,194824,Financial Mathematics,1,Master's degree,61,35,26,0,0,0,3,2,1,0,0,0,3,3,0,0,0,0,10,9,1,2,2,0,0,0,0,43,19,24
2014,194824,"Multi-/Interdisciplinary Studies, General",1,Bachelor's degree,0,0,0,0,0,0,0,0,0,0,0,0,0,0,0,0,0,0,0,0,0,0,0,0,0,0,0,0,0,0
2014,194824,"Multi-/Interdisciplinary Studies, General",1,Master's degree,1,1,0,0,0,0,0,0,0,0,0,0,0,0,0,0,0,0,1,1,0,0,0,0,0,0,0,0,0,0
2014,194824,"Science, Technology and Society",1,Bachelor's degree,2,2,0,0,0,0,1,1,0,0,0,0,0,0,0,0,0,0,0,0,0,1,1,0,0,0,0,0,0,0
2014,194824,"Science, Technology and Society",1,Master's degree,3,1,2,0,0,0,0,0,0,0,0,0,0,0,0,0,0,0,0,0,0,0,0,0,2,1,1,1,0,1
2014,194824,Natural Sciences,1,Master's degree,0,0,0,0,0,0,0,0,0,0,0,0,0,0,0,0,0,0,0,0,0,0,0,0,0,0,0,0,0,0
2014,194824,"Cognitive Science, General",1,Bachelor's degree,5,2,3,0,0,0,0,0,0,0,0,0,0,0,0,0,0,0,5,2,3,0,0,0,0,0,0,0,0,0
2014,194824,"Cognitive Science, General",1,Master's degree,4,2,2,0,0,0,0,0,0,0,0,0,0,0,0,0,0,0,4,2,2,0,0,0,0,0,0,0,0,0
2014,194824,Human Computer Interaction,1,Master's degree,2,2,0,0,0,0,0,0,0,0,0,0,0,0,0,0,0,0,2,2,0,0,0,0,0,0,0,0,0,0
2014,194824,Sustainability Studies,1,Bachelor's degree,1,1,0,0,0,0,0,0,0,0,0,0,0,0,0,0,0,0,1,1,0,0,0,0,0,0,0,0,0,0
2014,194824,"Multi-/Interdisciplinary Studies, Other",1,Bachelor's degree,14,7,7,0,0,0,1,1,0,0,0,0,0,0,0,0,0,0,12,6,6,1,0,1,0,0,0,0,0,0
2014,194824,"Multi-/Interdisciplinary Studies, Other",1,Master's degree,0,0,0,0,0,0,0,0,0,0,0,0,0,0,0,0,0,0,0,0,0,0,0,0,0,0,0,0,0,0
2014,194824,Philosophy,1,Bachelor's degree,2,2,0,0,0,0,0,0,0,1,1,0,0,0,0,0,0,0,1,1,0,0,0,0,0,0,0,0,0,0
2014,194824,Philosophy,1,Master's degree,0,0,0,0,0,0,0,0,0,0,0,0,0,0,0,0,0,0,0,0,0,0,0,0,0,0,0,0,0,0
2014,194824,Astronomy,1,Master's degree,2,1,1,0,0,0,0,0,0,0,0,0,0,0,0,0,0,0,2,1,1,0,0,0,0,0,0,0,0,0
2014,194824,"Chemistry, General",1,Bachelor's degree,14,4,10,0,0,0,1,0,1,0,0,0,0,0,0,0,0,0,13,4,9,0,0,0,0,0,0,0,0,0
2014,194824,"Chemistry, General",1,Master's degree,1,0,1,0,0,0,0,0,0,0,0,0,0,0,0,0,0,0,1,0,1,0,0,0,0,0,0,0,0,0
2014,194824,"Geology/Earth Science, General",1,Bachelor's degree,5,2,3,0,0,0,0,0,0,0,0,0,0,0,0,0,0,0,4,2,2,1,0,1,0,0,0,0,0,0
2014,194824,"Geology/Earth Science, General",1,Master's degree,1,0,1,0,0,0,0,0,0,0,0,0,0,0,0,0,0,0,1,0,1,0,0,0,0,0,0,0,0,0
2014,194824,Hydrology and Water Resources Science,1,Bachelor's degree,1,1,0,0,0,0,0,0,0,0,0,0,0,0,0,0,0,0,0,0,0,0,0,0,1,1,0,0,0,0
2014,194824,Hydrology and Water Resources Science,1,Master's degree,0,0,0,0,0,0,0,0,0,0,0,0,0,0,0,0,0,0,0,0,0,0,0,0,0,0,0,0,0,0
2014,194824,"Physics, General",1,Bachelor's degree,33,28,5,0,0,0,2,2,0,0,0,0,2,1,1,0,0,0,26,22,4,2,2,0,0,0,0,1,1,0
2014,194824,"Physics, General",1,Master's degree,10,8,2,0,0,0,1,1,0,0,0,0,0,0,0,0,0,0,6,5,1,0,0,0,0,0,0,3,2,1
2014,194824,"Physics, Other",1,Bachelor's degree,9,9,0,0,0,0,0,0,0,0,0,0,4,4,0,0,0,0,4,4,0,1,1,0,0,0,0,0,0,0
2014,194824,"Physical Sciences, Other",1,Bachelor's degree,0,0,0,0,0,0,0,0,0,0,0,0,0,0,0,0,0,0,0,0,0,0,0,0,0,0,0,0,0,0
2014,194824,"Physical Sciences, Other",1,Master's degree,0,0,0,0,0,0,0,0,0,0,0,0,0,0,0,0,0,0,0,0,0,0,0,0,0,0,0,0,0,0
2014,194824,"Psychology, General",1,Bachelor's degree,6,2,4,0,0,0,0,0,0,1,1,0,0,0,0,0,0,0,4,0,4,0,0,0,1,1,0,0,0,0
2014,194824,"Psychology, General",1,Master's degree,0,0,0,0,0,0,0,0,0,0,0,0,0,0,0,0,0,0,0,0,0,0,0,0,0,0,0,0,0,0
2014,194824,"Social Sciences, General",1,Bachelor's degree,0,0,0,0,0,0,0,0,0,0,0,0,0,0,0,0,0,0,0,0,0,0,0,0,0,0,0,0,0,0
2014,194824,"Social Sciences, General",1,Master's degree,0,0,0,0,0,0,0,0,0,0,0,0,0,0,0,0,0,0,0,0,0,0,0,0,0,0,0,0,0,0
2014,194824,"Economics, General",1,Bachelor's degree,0,0,0,0,0,0,0,0,0,0,0,0,0,0,0,0,0,0,0,0,0,0,0,0,0,0,0,0,0,0
2014,194824,"Economics, General",1,Master's degree,1,0,1,0,0,0,0,0,0,0,0,0,1,0,1,0,0,0,0,0,0,0,0,0,0,0,0,0,0,0
2014,194824,"Economics, Other",1,Master's degree,2,0,2,0,0,0,0,0,0,0,0,0,0,0,0,0,0,0,1,0,1,1,0,1,0,0,0,0,0,0
2014,194824,"Social Sciences, Other",1,Master's degree,0,0,0,0,0,0,0,0,0,0,0,0,0,0,0,0,0,0,0,0,0,0,0,0,0,0,0,0,0,0
2014,194824,"Visual and Performing Arts, General",1,Bachelor's degree,5,3,2,0,0,0,1,1,0,1,0,1,0,0,0,0,0,0,2,1,1,1,1,0,0,0,0,0,0,0
2014,194824,"Visual and Performing Arts, General",1,Master's degree,3,2,1,0,0,0,0,0,0,0,0,0,0,0,0,0,0,0,2,1,1,0,0,0,0,0,0,1,1,0
2014,194824,Game and Interactive Media Design,1,Bachelor's degree,30,26,4,0,0,0,4,3,1,1,1,0,3,3,0,0,0,0,20,17,3,0,0,0,1,1,0,1,1,0
2014,194824,Pre-Medicine/Pre-Medical Studies,1,Bachelor's degree,7,4,3,0,0,0,4,3,1,0,0,0,0,0,0,0,0,0,2,1,1,1,0,1,0,0,0,0,0,0
2014,194824,"Business Administration and Management, General",1,Bachelor's degree,66,45,21,0,0,0,6,3,3,0,0,0,4,4,0,0,0,0,46,33,13,2,1,1,3,2,1,5,2,3
2014,194824,"Business Administration and Management, General",1,Master's degree,64,35,29,0,0,0,3,2,1,1,0,1,4,4,0,0,0,0,22,13,9,0,0,0,2,1,1,32,15,17
2014,194824,"Logistics, Materials, and Supply Chain Management",1,Master's degree,3,2,1,0,0,0,0,0,0,1,0,1,1,1,0,0,0,0,0,0,0,0,0,0,0,0,0,1,1,0
2014,194824,Entrepreneurship/Entrepreneurial Studies,1,Master's degree,3,2,1,0,0,0,0,0,0,0,0,0,0,0,0,0,0,0,2,1,1,0,0,0,0,0,0,1,1,0
2014,194824,"Finance and Financial Management Services, Other",1,Master's degree,0,0,0,0,0,0,0,0,0,0,0,0,0,0,0,0,0,0,0,0,0,0,0,0,0,0,0,0,0,0
2014,194824,Business Statistics,1,Master's degree,10,2,8,0,0,0,1,0,1,1,0,1,0,0,0,0,0,0,0,0,0,1,1,0,0,0,0,7,1,6
2014,194824,"Business, Management, Marketing, and Related Support Services, Other",1,Master's degree,0,0,0,0,0,0,0,0,0,0,0,0,0,0,0,0,0,0,0,0,0,0,0,0,0,0,0,0,0,0
2014,194824,99,1,Bachelor's degree,1128,791,337,2,0,2,91,64,27,22,12,10,56,43,13,1,0,1,818,574,244,61,42,19,29,24,5,48,32,16
2014,194824,99,1,Master's degree,389,239,150,0,0,0,16,9,7,5,2,3,19,13,6,0,0,0,173,118,55,5,4,1,6,4,2,165,89,76
2016,194824,Environmental Science,1,Bachelor's degree,7,2,5,0,0,0,0,0,0,0,0,0,0,0,0,0,0,0,6,2,4,0,0,0,0,0,0,1,0,1
2016,194824,Architecture,1,Bachelor's degree,54,25,29,0,0,0,5,2,3,3,2,1,4,3,1,0,0,0,29,13,16,4,1,3,1,0,1,8,4,4
2016,194824,Architecture,1,Master's degree,15,6,9,0,0,0,3,0,3,0,0,0,0,0,0,0,0,0,6,3,3,0,0,0,0,0,0,6,3,3
2016,194824,Architectural and Building Sciences/Technology,1,Bachelor's degree,0,0,0,0,0,0,0,0,0,0,0,0,0,0,0,0,0,0,0,0,0,0,0,0,0,0,0,0,0,0
2016,194824,Architectural and Building Sciences/Technology,1,Master's degree,13,10,3,0,0,0,0,0,0,0,0,0,0,0,0,0,0,0,10,7,3,2,2,0,0,0,0,1,1,0
2016,194824,"Architecture and Related Services, Other",1,Bachelor's degree,0,0,0,0,0,0,0,0,0,0,0,0,0,0,0,0,0,0,0,0,0,0,0,0,0,0,0,0,0,0
2016,194824,"Architecture and Related Services, Other",1,Master's degree,4,3,1,0,0,0,0,0,0,0,0,0,0,0,0,0,0,0,2,2,0,0,0,0,0,0,0,2,1,1
2016,194824,"Communication, General",1,Bachelor's degree,4,1,3,0,0,0,1,0,1,1,1,0,0,0,0,0,0,0,1,0,1,0,0,0,1,0,1,0,0,0
2016,194824,Speech Communication and Rhetoric,1,Bachelor's degree,0,0,0,0,0,0,0,0,0,0,0,0,0,0,0,0,0,0,0,0,0,0,0,0,0,0,0,0,0,0
2016,194824,Speech Communication and Rhetoric,1,Master's degree,1,0,1,0,0,0,0,0,0,0,0,0,0,0,0,0,0,0,1,0,1,0,0,0,0,0,0,0,0,0
2016,194824,Digital Communication and Media/Multimedia,1,Bachelor's degree,13,3,10,0,0,0,1,0,1,1,1,0,0,0,0,0,0,0,9,2,7,1,0,1,0,0,0,1,0,1
2016,194824,Technical and Scientific Communication,1,Master's degree,0,0,0,0,0,0,0,0,0,0,0,0,0,0,0,0,0,0,0,0,0,0,0,0,0,0,0,0,0,0
2016,194824,"Computer and Information Sciences, General",1,Bachelor's degree,0,0,0,0,0,0,0,0,0,0,0,0,0,0,0,0,0,0,0,0,0,0,0,0,0,0,0,0,0,0
2016,194824,"Computer and Information Sciences, General",1,Master's degree,0,0,0,0,0,0,0,0,0,0,0,0,0,0,0,0,0,0,0,0,0,0,0,0,0,0,0,0,0,0
2016,194824,Information Technology,1,Bachelor's degree,18,11,7,0,0,0,4,1,3,2,2,0,0,0,0,0,0,0,10,7,3,1,1,0,0,0,0,1,0,1
2016,194824,Information Technology,1,Master's degree,38,25,13,0,0,0,2,2,0,0,0,0,1,1,0,0,0,0,9,6,3,1,1,0,0,0,0,25,15,10
2016,194824,Computer Science,1,Bachelor's degree,133,120,13,0,0,0,14,12,2,0,0,0,6,5,1,0,0,0,93,87,6,9,9,0,6,4,2,5,3,2
2016,194824,Computer Science,1,Master's degree,28,24,4,0,0,0,2,1,1,1,1,0,1,1,0,0,0,0,11,10,1,3,2,1,1,1,0,9,8,1
2016,194824,"Aerospace, Aeronautical, and Astronautical/Space Engineering, General",1,Bachelor's degree,78,66,12,0,0,0,4,3,1,3,3,0,9,7,2,0,0,0,49,42,7,5,4,1,4,4,0,4,3,1
2016,194824,"Aerospace, Aeronautical, and Astronautical/Space Engineering, General",1,Master's degree,11,8,3,0,0,0,1,0,1,0,0,0,2,1,1,0,0,0,5,5,0,0,0,0,1,1,0,2,1,1
2016,194824,Bioengineering and Biomedical Engineering,1,Bachelor's degree,97,52,45,0,0,0,7,4,3,4,3,1,8,6,2,0,0,0,65,33,32,6,3,3,2,1,1,5,2,3
2016,194824,Bioengineering and Biomedical Engineering,1,Master's degree,17,10,7,0,0,0,1,0,1,0,0,0,0,0,0,0,0,0,15,9,6,0,0,0,0,0,0,1,1,0
2016,194824,Chemical Engineering,1,Bachelor's degree,82,57,25,0,0,0,13,10,3,1,0,1,8,7,1,0,0,0,45,30,15,6,5,1,2,2,0,7,3,4
2016,194824,Chemical Engineering,1,Master's degree,9,8,1,0,0,0,1,1,0,0,0,0,0,0,0,0,0,0,4,3,1,0,0,0,0,0,0,4,4,0
2016,194824,"Civil Engineering, General",1,Bachelor's degree,53,35,18,0,0,0,9,5,4,3,1,2,5,1,4,0,0,0,31,25,6,0,0,0,2,1,1,3,2,1
2016,194824,"Civil Engineering, General",1,Master's degree,20,13,7,0,0,0,5,3,2,0,0,0,1,0,1,0,0,0,12,9,3,0,0,0,0,0,0,2,1,1
2016,194824,Transportation and Highway Engineering,1,Master's degree,1,0,1,0,0,0,0,0,0,0,0,0,0,0,0,0,0,0,1,0,1,0,0,0,0,0,0,0,0,0
2016,194824,Electrical and Electronics Engineering,1,Bachelor's degree,81,62,19,0,0,0,10,8,2,2,2,0,3,3,0,0,0,0,45,36,9,5,4,1,1,1,0,15,8,7
2016,194824,Electrical and Electronics Engineering,1,Master's degree,11,9,2,0,0,0,0,0,0,0,0,0,0,0,0,0,0,0,7,6,1,1,1,0,0,0,0,3,2,1
2016,194824,Engineering Physics/Applied Physics,1,Bachelor's degree,0,0,0,0,0,0,0,0,0,0,0,0,0,0,0,0,0,0,0,0,0,0,0,0,0,0,0,0,0,0
2016,194824,Engineering Physics/Applied Physics,1,Master's degree,0,0,0,0,0,0,0,0,0,0,0,0,0,0,0,0,0,0,0,0,0,0,0,0,0,0,0,0,0,0
2016,194824,Engineering Science,1,Bachelor's degree,2,1,1,0,0,0,0,0,0,0,0,0,0,0,0,0,0,0,2,1,1,0,0,0,0,0,0,0,0,0
2016,194824,Engineering Science,1,Master's degree,0,0,0,0,0,0,0,0,0,0,0,0,0,0,0,0,0,0,0,0,0,0,0,0,0,0,0,0,0,0
2016,194824,Environmental/Environmental Health Engineering,1,Bachelor's degree,22,7,15,0,0,0,1,1,0,1,0,1,1,0,1,0,0,0,15,3,12,2,2,0,0,0,0,2,1,1
2016,194824,Environmental/Environmental Health Engineering,1,Master's degree,6,1,5,0,0,0,1,1,0,1,0,1,0,0,0,0,0,0,4,0,4,0,0,0,0,0,0,0,0,0
2016,194824,Materials Engineering,1,Bachelor's degree,33,25,8,0,0,0,2,2,0,1,1,0,2,2,0,0,0,0,22,16,6,3,1,2,1,1,0,2,2,0
2016,194824,Materials Engineering,1,Master's degree,7,6,1,0,0,0,1,1,0,0,0,0,1,0,1,0,0,0,4,4,0,1,1,0,0,0,0,0,0,0
2016,194824,Mechanical Engineering,1,Bachelor's degree,190,152,38,1,1,0,15,11,4,4,4,0,12,8,4,0,0,0,137,110,27,7,6,1,2,2,0,12,10,2
2016,194824,Mechanical Engineering,1,Master's degree,34,28,6,0,0,0,2,1,1,0,0,0,0,0,0,0,0,0,24,19,5,2,2,0,1,1,0,5,5,0
2016,194824,Nuclear Engineering,1,Bachelor's degree,33,29,4,0,0,0,3,3,0,0,0,0,2,1,1,0,0,0,20,17,3,5,5,0,2,2,0,1,1,0
2016,194824,Nuclear Engineering,1,Master's degree,7,7,0,0,0,0,1,1,0,0,0,0,0,0,0,0,0,0,4,4,0,1,1,0,0,0,0,1,1,0
2016,194824,Systems Engineering,1,Master's degree,0,0,0,0,0,0,0,0,0,0,0,0,0,0,0,0,0,0,0,0,0,0,0,0,0,0,0,0,0,0
2016,194824,Industrial Engineering,1,Bachelor's degree,37,24,13,0,0,0,3,2,1,2,1,1,2,2,0,0,0,0,25,15,10,1,0,1,0,0,0,4,4,0
2016,194824,Industrial Engineering,1,Master's degree,3,1,2,0,0,0,1,0,1,0,0,0,0,0,0,0,0,0,1,0,1,0,0,0,0,0,0,1,1,0
2016,194824,Operations Research,1,Master's degree,0,0,0,0,0,0,0,0,0,0,0,0,0,0,0,0,0,0,0,0,0,0,0,0,0,0,0,0,0,0
2016,194824,Computer/Computer Systems Technology/Technician,1,Bachelor's degree,54,49,5,0,0,0,12,10,2,1,1,0,4,4,0,0,0,0,27,26,1,5,4,1,1,1,0,4,3,1
2016,194824,Computer/Computer Systems Technology/Technician,1,Master's degree,4,3,1,0,0,0,0,0,0,0,0,0,0,0,0,0,0,0,2,2,0,1,1,0,0,0,0,1,0,1
2016,194824,Pre-Law Studies,1,Bachelor's degree,0,0,0,0,0,0,0,0,0,0,0,0,0,0,0,0,0,0,0,0,0,0,0,0,0,0,0,0,0,0
2016,194824,"Biology/Biological Sciences, General",1,Bachelor's degree,25,13,12,0,0,0,5,5,0,1,1,0,1,0,1,0,0,0,13,5,8,3,1,2,0,0,0,2,1,1
2016,194824,"Biology/Biological Sciences, General",1,Master's degree,3,1,2,0,0,0,0,0,0,0,0,0,0,0,0,0,0,0,3,1,2,0,0,0,0,0,0,0,0,0
2016,194824,Biochemistry and Molecular Biology,1,Bachelor's degree,0,0,0,0,0,0,0,0,0,0,0,0,0,0,0,0,0,0,0,0,0,0,0,0,0,0,0,0,0,0
2016,194824,Biochemistry and Molecular Biology,1,Master's degree,0,0,0,0,0,0,0,0,0,0,0,0,0,0,0,0,0,0,0,0,0,0,0,0,0,0,0,0,0,0
2016,194824,"Biochemistry, Biophysics and Molecular Biology, Other",1,Bachelor's degree,19,5,14,0,0,0,0,0,0,0,0,0,0,0,0,0,0,0,13,4,9,4,1,3,1,0,1,1,0,1
2016,194824,"Biochemistry, Biophysics and Molecular Biology, Other",1,Master's degree,0,0,0,0,0,0,0,0,0,0,0,0,0,0,0,0,0,0,0,0,0,0,0,0,0,0,0,0,0,0
2016,194824,Bioinformatics,1,Bachelor's degree,3,3,0,0,0,0,1,1,0,1,1,0,0,0,0,0,0,0,1,1,0,0,0,0,0,0,0,0,0,0
2016,194824,"Biological and Biomedical Sciences, Other",1,Bachelor's degree,0,0,0,0,0,0,0,0,0,0,0,0,0,0,0,0,0,0,0,0,0,0,0,0,0,0,0,0,0,0
2016,194824,"Mathematics, General",1,Bachelor's degree,40,28,12,0,0,0,2,1,1,1,1,0,4,1,3,0,0,0,17,12,5,3,3,0,2,2,0,11,8,3
2016,194824,"Mathematics, General",1,Master's degree,0,0,0,0,0,0,0,0,0,0,0,0,0,0,0,0,0,0,0,0,0,0,0,0,0,0,0,0,0,0
2016,194824,"Applied Mathematics, General",1,Master's degree,22,20,2,0,0,0,0,0,0,1,1,0,3,3,0,0,0,0,8,8,0,1,1,0,0,0,0,9,7,2
2016,194824,Financial Mathematics,1,Master's degree,50,26,24,0,0,0,3,2,1,3,2,1,1,1,0,0,0,0,7,5,2,2,0,2,0,0,0,34,16,18
2016,194824,"Multi-/Interdisciplinary Studies, General",1,Bachelor's degree,4,3,1,0,0,0,0,0,0,0,0,0,0,0,0,0,0,0,4,3,1,0,0,0,0,0,0,0,0,0
2016,194824,"Multi-/Interdisciplinary Studies, General",1,Master's degree,1,1,0,0,0,0,0,0,0,0,0,0,0,0,0,0,0,0,0,0,0,0,0,0,0,0,0,1,1,0
2016,194824,"Science, Technology and Society",1,Bachelor's degree,3,1,2,0,0,0,0,0,0,0,0,0,1,1,0,0,0,0,2,0,2,0,0,0,0,0,0,0,0,0
2016,194824,"Science, Technology and Society",1,Master's degree,1,1,0,0,0,0,0,0,0,0,0,0,0,0,0,0,0,0,1,1,0,0,0,0,0,0,0,0,0,0
2016,194824,Natural Sciences,1,Master's degree,0,0,0,0,0,0,0,0,0,0,0,0,0,0,0,0,0,0,0,0,0,0,0,0,0,0,0,0,0,0
2016,194824,"Cognitive Science, General",1,Bachelor's degree,6,4,2,0,0,0,0,0,0,0,0,0,0,0,0,0,0,0,6,4,2,0,0,0,0,0,0,0,0,0
2016,194824,"Cognitive Science, General",1,Master's degree,1,1,0,0,0,0,0,0,0,0,0,0,0,0,0,0,0,0,1,1,0,0,0,0,0,0,0,0,0,0
2016,194824,Human Computer Interaction,1,Master's degree,1,0,1,0,0,0,0,0,0,0,0,0,0,0,0,0,0,0,1,0,1,0,0,0,0,0,0,0,0,0
2016,194824,Sustainability Studies,1,Bachelor's degree,3,0,3,0,0,0,0,0,0,1,0,1,0,0,0,0,0,0,2,0,2,0,0,0,0,0,0,0,0,0
2016,194824,"Multi-/Interdisciplinary Studies, Other",1,Bachelor's degree,9,4,5,0,0,0,0,0,0,0,0,0,3,2,1,0,0,0,6,2,4,0,0,0,0,0,0,0,0,0
2016,194824,"Multi-/Interdisciplinary Studies, Other",1,Master's degree,0,0,0,0,0,0,0,0,0,0,0,0,0,0,0,0,0,0,0,0,0,0,0,0,0,0,0,0,0,0
2016,194824,Philosophy,1,Bachelor's degree,0,0,0,0,0,0,0,0,0,0,0,0,0,0,0,0,0,0,0,0,0,0,0,0,0,0,0,0,0,0
2016,194824,Philosophy,1,Master's degree,0,0,0,0,0,0,0,0,0,0,0,0,0,0,0,0,0,0,0,0,0,0,0,0,0,0,0,0,0,0
2016,194824,Astronomy,1,Master's degree,1,1,0,0,0,0,0,0,0,0,0,0,0,0,0,0,0,0,1,1,0,0,0,0,0,0,0,0,0,0
2016,194824,"Chemistry, General",1,Bachelor's degree,12,9,3,0,0,0,2,2,0,0,0,0,0,0,0,0,0,0,6,4,2,3,2,1,0,0,0,1,1,0
2016,194824,"Chemistry, General",1,Master's degree,0,0,0,0,0,0,0,0,0,0,0,0,0,0,0,0,0,0,0,0,0,0,0,0,0,0,0,0,0,0
2016,194824,"Geology/Earth Science, General",1,Bachelor's degree,2,2,0,0,0,0,0,0,0,0,0,0,0,0,0,0,0,0,1,1,0,1,1,0,0,0,0,0,0,0
2016,194824,"Geology/Earth Science, General",1,Master's degree,4,2,2,0,0,0,0,0,0,0,0,0,1,1,0,0,0,0,3,1,2,0,0,0,0,0,0,0,0,0
2016,194824,Hydrology and Water Resources Science,1,Bachelor's degree,0,0,0,0,0,0,0,0,0,0,0,0,0,0,0,0,0,0,0,0,0,0,0,0,0,0,0,0,0,0
2016,194824,Hydrology and Water Resources Science,1,Master's degree,0,0,0,0,0,0,0,0,0,0,0,0,0,0,0,0,0,0,0,0,0,0,0,0,0,0,0,0,0,0
2016,194824,"Physics, General",1,Bachelor's degree,22,16,6,0,0,0,1,0,1,0,0,0,1,1,0,0,0,0,18,13,5,2,2,0,0,0,0,0,0,0
2016,194824,"Physics, General",1,Master's degree,7,5,2,0,0,0,0,0,0,0,0,0,1,1,0,0,0,0,6,4,2,0,0,0,0,0,0,0,0,0
2016,194824,"Physics, Other",1,Bachelor's degree,7,5,2,0,0,0,0,0,0,0,0,0,1,1,0,0,0,0,4,3,1,1,0,1,0,0,0,1,1,0
2016,194824,"Physical Sciences, Other",1,Bachelor's degree,0,0,0,0,0,0,0,0,0,0,0,0,0,0,0,0,0,0,0,0,0,0,0,0,0,0,0,0,0,0
2016,194824,"Physical Sciences, Other",1,Master's degree,0,0,0,0,0,0,0,0,0,0,0,0,0,0,0,0,0,0,0,0,0,0,0,0,0,0,0,0,0,0
2016,194824,"Psychology, General",1,Bachelor's degree,10,7,3,0,0,0,2,2,0,0,0,0,1,1,0,0,0,0,6,4,2,1,0,1,0,0,0,0,0,0
2016,194824,"Psychology, General",1,Master's degree,0,0,0,0,0,0,0,0,0,0,0,0,0,0,0,0,0,0,0,0,0,0,0,0,0,0,0,0,0,0
2016,194824,"Social Sciences, General",1,Bachelor's degree,0,0,0,0,0,0,0,0,0,0,0,0,0,0,0,0,0,0,0,0,0,0,0,0,0,0,0,0,0,0
2016,194824,"Social Sciences, General",1,Master's degree,0,0,0,0,0,0,0,0,0,0,0,0,0,0,0,0,0,0,0,0,0,0,0,0,0,0,0,0,0,0
2016,194824,"Economics, General",1,Bachelor's degree,4,4,0,0,0,0,0,0,0,1,1,0,0,0,0,0,0,0,1,1,0,1,1,0,0,0,0,1,1,0
2016,194824,"Economics, General",1,Master's degree,0,0,0,0,0,0,0,0,0,0,0,0,0,0,0,0,0,0,0,0,0,0,0,0,0,0,0,0,0,0
2016,194824,"Economics, Other",1,Master's degree,0,0,0,0,0,0,0,0,0,0,0,0,0,0,0,0,0,0,0,0,0,0,0,0,0,0,0,0,0,0
2016,194824,"Social Sciences, Other",1,Master's degree,0,0,0,0,0,0,0,0,0,0,0,0,0,0,0,0,0,0,0,0,0,0,0,0,0,0,0,0,0,0
2016,194824,"Visual and Performing Arts, General",1,Bachelor's degree,0,0,0,0,0,0,0,0,0,0,0,0,0,0,0,0,0,0,0,0,0,0,0,0,0,0,0,0,0,0
2016,194824,"Visual and Performing Arts, General",1,Master's degree,4,3,1,0,0,0,0,0,0,0,0,0,1,1,0,0,0,0,3,2,1,0,0,0,0,0,0,0,0,0
2016,194824,Game and Interactive Media Design,1,Bachelor's degree,30,27,3,0,0,0,3,3,0,1,1,0,1,1,0,0,0,0,23,20,3,1,1,0,0,0,0,1,1,0
2016,194824,Pre-Medicine/Pre-Medical Studies,1,Bachelor's degree,10,4,6,0,0,0,5,2,3,0,0,0,0,0,0,0,0,0,1,0,1,4,2,2,0,0,0,0,0,0
2016,194824,"Business Administration and Management, General",1,Bachelor's degree,67,37,30,1,0,1,6,2,4,4,3,1,4,3,1,0,0,0,35,19,16,5,3,2,2,2,0,10,5,5
2016,194824,"Business Administration and Management, General",1,Master's degree,34,18,16,0,0,0,1,1,0,1,0,1,1,1,0,0,0,0,12,6,6,1,0,1,2,1,1,16,9,7
2016,194824,"Logistics, Materials, and Supply Chain Management",1,Master's degree,0,0,0,0,0,0,0,0,0,0,0,0,0,0,0,0,0,0,0,0,0,0,0,0,0,0,0,0,0,0
2016,194824,Entrepreneurship/Entrepreneurial Studies,1,Master's degree,10,7,3,0,0,0,0,0,0,1,1,0,3,3,0,0,0,0,5,2,3,0,0,0,0,0,0,1,1,0
2016,194824,"Finance and Financial Management Services, Other",1,Master's degree,0,0,0,0,0,0,0,0,0,0,0,0,0,0,0,0,0,0,0,0,0,0,0,0,0,0,0,0,0,0
2016,194824,Business Statistics,1,Master's degree,28,15,13,0,0,0,0,0,0,1,1,0,0,0,0,0,0,0,7,6,1,3,1,2,0,0,0,17,7,10
2016,194824,"Management Sciences and Quantitative Methods, Other",1,Master's degree,12,6,6,0,0,0,3,1,2,1,0,1,0,0,0,0,0,0,4,2,2,0,0,0,0,0,0,4,3,1
2016,194824,"Business, Management, Marketing, and Related Support Services, Other",1,Master's degree,0,0,0,0,0,0,0,0,0,0,0,0,0,0,0,0,0,0,0,0,0,0,0,0,0,0,0,0,0,0
2016,194824,99,1,Bachelor's degree,1267,893,374,2,1,1,131,92,39,39,30,9,83,60,23,0,0,0,790,561,229,89,62,27,30,23,7,103,64,39
2016,194824,99,1,Master's degree,408,269,139,0,0,0,28,15,13,10,6,4,17,14,3,0,0,0,184,129,55,19,13,6,5,4,1,145,88,57
2017,194824,Environmental Science,1,Bachelor's degree,5,3,2,0,0,0,0,0,0,0,0,0,0,0,0,0,0,0,4,2,2,1,1,0,0,0,0,0,0,0
2017,194824,Architecture,1,Bachelor's degree,53,27,26,0,0,0,3,2,1,0,0,0,7,4,3,0,0,0,33,17,16,3,2,1,1,0,1,6,2,4
2017,194824,Architecture,1,Master's degree,11,6,5,0,0,0,2,0,2,0,0,0,0,0,0,0,0,0,4,3,1,1,1,0,0,0,0,4,2,2
2017,194824,Architectural and Building Sciences/Technology,1,Bachelor's degree,0,0,0,0,0,0,0,0,0,0,0,0,0,0,0,0,0,0,0,0,0,0,0,0,0,0,0,0,0,0
2017,194824,Architectural and Building Sciences/Technology,1,Master's degree,10,6,4,0,0,0,1,1,0,0,0,0,1,0,1,0,0,0,6,3,3,1,1,0,0,0,0,1,1,0
2017,194824,"Architecture and Related Services, Other",1,Bachelor's degree,0,0,0,0,0,0,0,0,0,0,0,0,0,0,0,0,0,0,0,0,0,0,0,0,0,0,0,0,0,0
2017,194824,"Architecture and Related Services, Other",1,Master's degree,2,1,1,0,0,0,0,0,0,0,0,0,0,0,0,0,0,0,1,1,0,0,0,0,0,0,0,1,0,1
2017,194824,"Communication, General",1,Bachelor's degree,4,2,2,0,0,0,1,0,1,0,0,0,0,0,0,0,0,0,2,2,0,1,0,1,0,0,0,0,0,0
2017,194824,Speech Communication and Rhetoric,1,Bachelor's degree,0,0,0,0,0,0,0,0,0,0,0,0,0,0,0,0,0,0,0,0,0,0,0,0,0,0,0,0,0,0
2017,194824,Speech Communication and Rhetoric,1,Master's degree,0,0,0,0,0,0,0,0,0,0,0,0,0,0,0,0,0,0,0,0,0,0,0,0,0,0,0,0,0,0
2017,194824,Digital Communication and Media/Multimedia,1,Bachelor's degree,12,3,9,0,0,0,1,0,1,0,0,0,2,0,2,0,0,0,6,2,4,1,1,0,0,0,0,2,0,2
2017,194824,Technical and Scientific Communication,1,Master's degree,0,0,0,0,0,0,0,0,0,0,0,0,0,0,0,0,0,0,0,0,0,0,0,0,0,0,0,0,0,0
2017,194824,"Computer and Information Sciences, General",1,Bachelor's degree,0,0,0,0,0,0,0,0,0,0,0,0,0,0,0,0,0,0,0,0,0,0,0,0,0,0,0,0,0,0
2017,194824,"Computer and Information Sciences, General",1,Master's degree,0,0,0,0,0,0,0,0,0,0,0,0,0,0,0,0,0,0,0,0,0,0,0,0,0,0,0,0,0,0
2017,194824,Information Technology,1,Bachelor's degree,23,16,7,0,0,0,4,1,3,1,1,0,1,1,0,0,0,0,13,11,2,1,1,0,2,1,1,1,0,1
2017,194824,Information Technology,1,Master's degree,31,19,12,0,0,0,1,0,1,1,1,0,1,1,0,0,0,0,10,7,3,0,0,0,0,0,0,18,10,8
2017,194824,Computer Science,1,Bachelor's degree,167,147,20,0,0,0,27,22,5,0,0,0,14,12,2,0,0,0,104,93,11,9,9,0,5,5,0,8,6,2
2017,194824,Computer Science,1,Master's degree,23,21,2,0,0,0,5,5,0,0,0,0,1,0,1,0,0,0,9,9,0,0,0,0,0,0,0,8,7,1
2017,194824,"Aerospace, Aeronautical, and Astronautical/Space Engineering, General",1,Bachelor's degree,87,79,8,0,0,0,8,8,0,0,0,0,9,9,0,0,0,0,61,54,7,3,2,1,3,3,0,3,3,0
2017,194824,"Aerospace, Aeronautical, and Astronautical/Space Engineering, General",1,Master's degree,19,17,2,0,0,0,2,2,0,1,1,0,2,2,0,0,0,0,10,9,1,1,1,0,0,0,0,3,2,1
2017,194824,Bioengineering and Biomedical Engineering,1,Bachelor's degree,101,47,54,0,0,0,11,5,6,2,1,1,9,3,6,0,0,0,67,30,37,9,7,2,1,0,1,2,1,1
2017,194824,Bioengineering and Biomedical Engineering,1,Master's degree,11,7,4,0,0,0,1,1,0,1,0,1,0,0,0,0,0,0,7,5,2,1,1,0,0,0,0,1,0,1
2017,194824,Chemical Engineering,1,Bachelor's degree,93,55,38,0,0,0,10,3,7,0,0,0,7,4,3,0,0,0,69,44,25,1,1,0,0,0,0,6,3,3
2017,194824,Chemical Engineering,1,Master's degree,2,2,0,0,0,0,0,0,0,0,0,0,0,0,0,0,0,0,2,2,0,0,0,0,0,0,0,0,0,0
2017,194824,"Civil Engineering, General",1,Bachelor's degree,62,40,22,0,0,0,4,3,1,3,2,1,3,3,0,0,0,0,47,29,18,2,1,1,2,1,1,1,1,0
2017,194824,"Civil Engineering, General",1,Master's degree,22,13,9,0,0,0,1,0,1,1,0,1,2,2,0,0,0,0,16,9,7,0,0,0,1,1,0,1,1,0
2017,194824,Transportation and Highway Engineering,1,Master's degree,5,3,2,0,0,0,0,0,0,0,0,0,1,0,1,0,0,0,4,3,1,0,0,0,0,0,0,0,0,0
2017,194824,Electrical and Electronics Engineering,1,Bachelor's degree,94,74,20,0,0,0,14,11,3,1,1,0,7,5,2,0,0,0,44,35,9,6,5,1,3,3,0,19,14,5
2017,194824,Electrical and Electronics Engineering,1,Master's degree,19,18,1,0,0,0,3,3,0,0,0,0,1,1,0,0,0,0,7,7,0,0,0,0,0,0,0,8,7,1
2017,194824,Engineering Physics/Applied Physics,1,Bachelor's degree,0,0,0,0,0,0,0,0,0,0,0,0,0,0,0,0,0,0,0,0,0,0,0,0,0,0,0,0,0,0
2017,194824,Engineering Physics/Applied Physics,1,Master's degree,0,0,0,0,0,0,0,0,0,0,0,0,0,0,0,0,0,0,0,0,0,0,0,0,0,0,0,0,0,0
2017,194824,Engineering Science,1,Bachelor's degree,1,1,0,0,0,0,0,0,0,0,0,0,0,0,0,0,0,0,1,1,0,0,0,0,0,0,0,0,0,0
2017,194824,Engineering Science,1,Master's degree,0,0,0,0,0,0,0,0,0,0,0,0,0,0,0,0,0,0,0,0,0,0,0,0,0,0,0,0,0,0
2017,194824,Environmental/Environmental Health Engineering,1,Bachelor's degree,16,9,7,0,0,0,1,0,1,1,1,0,0,0,0,0,0,0,12,8,4,1,0,1,1,0,1,0,0,0
2017,194824,Environmental/Environmental Health Engineering,1,Master's degree,5,4,1,0,0,0,0,0,0,0,0,0,0,0,0,0,0,0,5,4,1,0,0,0,0,0,0,0,0,0
2017,194824,Materials Engineering,1,Bachelor's degree,28,20,8,0,0,0,2,2,0,0,0,0,0,0,0,0,0,0,15,12,3,2,1,1,1,1,0,8,4,4
2017,194824,Materials Engineering,1,Master's degree,6,6,0,0,0,0,0,0,0,0,0,0,0,0,0,0,0,0,5,5,0,0,0,0,0,0,0,1,1,0
2017,194824,Mechanical Engineering,1,Bachelor's degree,226,178,48,0,0,0,17,12,5,6,4,2,26,20,6,0,0,0,146,118,28,9,5,4,3,2,1,19,17,2
2017,194824,Mechanical Engineering,1,Master's degree,41,33,8,0,0,0,4,4,0,0,0,0,3,3,0,0,0,0,28,21,7,0,0,0,0,0,0,6,5,1
2017,194824,Nuclear Engineering,1,Bachelor's degree,33,25,8,0,0,0,3,1,2,0,0,0,3,3,0,0,0,0,23,18,5,2,2,0,0,0,0,2,1,1
2017,194824,Nuclear Engineering,1,Master's degree,8,6,2,0,0,0,2,0,2,0,0,0,1,1,0,0,0,0,5,5,0,0,0,0,0,0,0,0,0,0
2017,194824,Systems Engineering,1,Master's degree,6,4,2,0,0,0,0,0,0,0,0,0,1,0,1,0,0,0,4,3,1,0,0,0,0,0,0,1,1,0
2017,194824,Industrial Engineering,1,Bachelor's degree,59,40,19,0,0,0,5,4,1,2,2,0,8,5,3,0,0,0,30,21,9,6,3,3,0,0,0,8,5,3
2017,194824,Industrial Engineering,1,Master's degree,6,3,3,0,0,0,0,0,0,0,0,0,1,1,0,0,0,0,2,2,0,0,0,0,0,0,0,3,0,3
2017,194824,Operations Research,1,Master's degree,0,0,0,0,0,0,0,0,0,0,0,0,0,0,0,0,0,0,0,0,0,0,0,0,0,0,0,0,0,0
2017,194824,Computer/Computer Systems Technology/Technician,1,Bachelor's degree,71,59,12,0,0,0,15,11,4,3,3,0,6,6,0,0,0,0,35,30,5,7,4,3,1,1,0,4,4,0
2017,194824,Computer/Computer Systems Technology/Technician,1,Master's degree,9,9,0,0,0,0,2,2,0,0,0,0,0,0,0,0,0,0,2,2,0,0,0,0,1,1,0,4,4,0
2017,194824,Pre-Law Studies,1,Bachelor's degree,0,0,0,0,0,0,0,0,0,0,0,0,0,0,0,0,0,0,0,0,0,0,0,0,0,0,0,0,0,0
2017,194824,"Biology/Biological Sciences, General",1,Bachelor's degree,26,11,15,0,0,0,7,6,1,1,0,1,1,0,1,0,0,0,14,4,10,2,1,1,0,0,0,1,0,1
2017,194824,"Biology/Biological Sciences, General",1,Master's degree,10,5,5,0,0,0,0,0,0,0,0,0,0,0,0,0,0,0,9,4,5,1,1,0,0,0,0,0,0,0
2017,194824,Biochemistry and Molecular Biology,1,Bachelor's degree,0,0,0,0,0,0,0,0,0,0,0,0,0,0,0,0,0,0,0,0,0,0,0,0,0,0,0,0,0,0
2017,194824,Biochemistry and Molecular Biology,1,Master's degree,0,0,0,0,0,0,0,0,0,0,0,0,0,0,0,0,0,0,0,0,0,0,0,0,0,0,0,0,0,0
2017,194824,"Biochemistry, Biophysics and Molecular Biology, Other",1,Bachelor's degree,20,7,13,0,0,0,2,0,2,0,0,0,1,1,0,0,0,0,14,5,9,1,1,0,1,0,1,1,0,1
2017,194824,"Biochemistry, Biophysics and Molecular Biology, Other",1,Master's degree,0,0,0,0,0,0,0,0,0,0,0,0,0,0,0,0,0,0,0,0,0,0,0,0,0,0,0,0,0,0
2017,194824,Bioinformatics,1,Bachelor's degree,12,7,5,0,0,0,1,1,0,0,0,0,1,0,1,0,0,0,9,5,4,1,1,0,0,0,0,0,0,0
2017,194824,"Biological and Biomedical Sciences, Other",1,Bachelor's degree,0,0,0,0,0,0,0,0,0,0,0,0,0,0,0,0,0,0,0,0,0,0,0,0,0,0,0,0,0,0
2017,194824,"Mathematics, General",1,Bachelor's degree,66,44,22,0,0,0,4,1,3,0,0,0,1,1,0,0,0,0,32,25,7,2,2,0,3,0,3,24,15,9
2017,194824,"Mathematics, General",1,Master's degree,1,1,0,0,0,0,0,0,0,0,0,0,0,0,0,0,0,0,1,1,0,0,0,0,0,0,0,0,0,0
2017,194824,"Applied Mathematics, General",1,Master's degree,22,17,5,0,0,0,0,0,0,0,0,0,2,2,0,0,0,0,9,6,3,1,1,0,0,0,0,10,8,2
2017,194824,Financial Mathematics,1,Master's degree,44,33,11,0,0,0,1,1,0,0,0,0,2,2,0,0,0,0,7,6,1,1,1,0,1,1,0,32,22,10
2017,194824,"Multi-/Interdisciplinary Studies, General",1,Bachelor's degree,0,0,0,0,0,0,0,0,0,0,0,0,0,0,0,0,0,0,0,0,0,0,0,0,0,0,0,0,0,0
2017,194824,"Multi-/Interdisciplinary Studies, General",1,Master's degree,1,1,0,0,0,0,0,0,0,0,0,0,0,0,0,0,0,0,1,1,0,0,0,0,0,0,0,0,0,0
2017,194824,"Science, Technology and Society",1,Bachelor's degree,7,1,6,0,0,0,1,0,1,1,0,1,0,0,0,0,0,0,5,1,4,0,0,0,0,0,0,0,0,0
2017,194824,"Science, Technology and Society",1,Master's degree,2,0,2,0,0,0,0,0,0,1,0,1,0,0,0,0,0,0,1,0,1,0,0,0,0,0,0,0,0,0
2017,194824,Natural Sciences,1,Master's degree,0,0,0,0,0,0,0,0,0,0,0,0,0,0,0,0,0,0,0,0,0,0,0,0,0,0,0,0,0,0
2017,194824,"Cognitive Science, General",1,Bachelor's degree,4,2,2,0,0,0,0,0,0,0,0,0,1,0,1,0,0,0,3,2,1,0,0,0,0,0,0,0,0,0
2017,194824,"Cognitive Science, General",1,Master's degree,1,1,0,0,0,0,0,0,0,0,0,0,0,0,0,0,0,0,1,1,0,0,0,0,0,0,0,0,0,0
2017,194824,Human Computer Interaction,1,Master's degree,0,0,0,0,0,0,0,0,0,0,0,0,0,0,0,0,0,0,0,0,0,0,0,0,0,0,0,0,0,0
2017,194824,Sustainability Studies,1,Bachelor's degree,4,0,4,0,0,0,1,0,1,0,0,0,0,0,0,0,0,0,1,0,1,2,0,2,0,0,0,0,0,0
2017,194824,"Multi-/Interdisciplinary Studies, Other",1,Bachelor's degree,11,5,6,0,0,0,0,0,0,0,0,0,0,0,0,0,0,0,9,5,4,1,0,1,0,0,0,1,0,1
2017,194824,"Multi-/Interdisciplinary Studies, Other",1,Master's degree,0,0,0,0,0,0,0,0,0,0,0,0,0,0,0,0,0,0,0,0,0,0,0,0,0,0,0,0,0,0
2017,194824,Philosophy,1,Bachelor's degree,0,0,0,0,0,0,0,0,0,0,0,0,0,0,0,0,0,0,0,0,0,0,0,0,0,0,0,0,0,0
2017,194824,Philosophy,1,Master's degree,0,0,0,0,0,0,0,0,0,0,0,0,0,0,0,0,0,0,0,0,0,0,0,0,0,0,0,0,0,0
2017,194824,Astronomy,1,Master's degree,1,0,1,0,0,0,0,0,0,0,0,0,0,0,0,0,0,0,0,0,0,1,0,1,0,0,0,0,0,0
2017,194824,"Chemistry, General",1,Bachelor's degree,12,8,4,0,0,0,1,1,0,0,0,0,1,1,0,0,0,0,8,5,3,1,0,1,0,0,0,1,1,0
2017,194824,"Chemistry, General",1,Master's degree,3,3,0,0,0,0,0,0,0,0,0,0,0,0,0,0,0,0,2,2,0,1,1,0,0,0,0,0,0,0
2017,194824,"Geology/Earth Science, General",1,Bachelor's degree,2,2,0,0,0,0,0,0,0,0,0,0,0,0,0,0,0,0,2,2,0,0,0,0,0,0,0,0,0,0
2017,194824,"Geology/Earth Science, General",1,Master's degree,4,1,3,0,0,0,0,0,0,0,0,0,0,0,0,0,0,0,3,1,2,0,0,0,0,0,0,1,0,1
2017,194824,Hydrology and Water Resources Science,1,Bachelor's degree,1,1,0,0,0,0,0,0,0,0,0,0,0,0,0,0,0,0,1,1,0,0,0,0,0,0,0,0,0,0
2017,194824,Hydrology and Water Resources Science,1,Master's degree,0,0,0,0,0,0,0,0,0,0,0,0,0,0,0,0,0,0,0,0,0,0,0,0,0,0,0,0,0,0
2017,194824,"Physics, General",1,Bachelor's degree,17,15,2,0,0,0,0,0,0,0,0,0,4,4,0,0,0,0,11,9,2,1,1,0,0,0,0,1,1,0
2017,194824,"Physics, General",1,Master's degree,12,11,1,0,0,0,0,0,0,0,0,0,0,0,0,0,0,0,10,9,1,0,0,0,1,1,0,1,1,0
2017,194824,"Physics, Other",1,Bachelor's degree,10,5,5,0,0,0,1,1,0,0,0,0,0,0,0,0,0,0,7,4,3,2,0,2,0,0,0,0,0,0
2017,194824,"Physical Sciences, Other",1,Bachelor's degree,0,0,0,0,0,0,0,0,0,0,0,0,0,0,0,0,0,0,0,0,0,0,0,0,0,0,0,0,0,0
2017,194824,"Physical Sciences, Other",1,Master's degree,0,0,0,0,0,0,0,0,0,0,0,0,0,0,0,0,0,0,0,0,0,0,0,0,0,0,0,0,0,0
2017,194824,"Psychology, General",1,Bachelor's degree,6,3,3,0,0,0,1,1,0,0,0,0,0,0,0,0,0,0,5,2,3,0,0,0,0,0,0,0,0,0
2017,194824,"Psychology, General",1,Master's degree,0,0,0,0,0,0,0,0,0,0,0,0,0,0,0,0,0,0,0,0,0,0,0,0,0,0,0,0,0,0
2017,194824,"Social Sciences, General",1,Bachelor's degree,0,0,0,0,0,0,0,0,0,0,0,0,0,0,0,0,0,0,0,0,0,0,0,0,0,0,0,0,0,0
2017,194824,"Social Sciences, General",1,Master's degree,0,0,0,0,0,0,0,0,0,0,0,0,0,0,0,0,0,0,0,0,0,0,0,0,0,0,0,0,0,0
2017,194824,"Economics, General",1,Bachelor's degree,6,5,1,0,0,0,0,0,0,0,0,0,1,1,0,0,0,0,2,1,1,0,0,0,0,0,0,3,3,0
2017,194824,"Economics, General",1,Master's degree,0,0,0,0,0,0,0,0,0,0,0,0,0,0,0,0,0,0,0,0,0,0,0,0,0,0,0,0,0,0
2017,194824,"Economics, Other",1,Master's degree,0,0,0,0,0,0,0,0,0,0,0,0,0,0,0,0,0,0,0,0,0,0,0,0,0,0,0,0,0,0
2017,194824,"Social Sciences, Other",1,Master's degree,0,0,0,0,0,0,0,0,0,0,0,0,0,0,0,0,0,0,0,0,0,0,0,0,0,0,0,0,0,0
2017,194824,"Visual and Performing Arts, General",1,Bachelor's degree,3,2,1,0,0,0,0,0,0,0,0,0,0,0,0,0,0,0,1,1,0,1,1,0,1,0,1,0,0,0
2017,194824,"Visual and Performing Arts, General",1,Master's degree,2,2,0,0,0,0,0,0,0,0,0,0,0,0,0,0,0,0,2,2,0,0,0,0,0,0,0,0,0,0
2017,194824,Game and Interactive Media Design,1,Bachelor's degree,31,24,7,0,0,0,5,4,1,0,0,0,1,0,1,0,0,0,22,17,5,0,0,0,1,1,0,2,2,0
2017,194824,Pre-Medicine/Pre-Medical Studies,1,Bachelor's degree,9,6,3,0,0,0,7,5,2,0,0,0,0,0,0,0,0,0,2,1,1,0,0,0,0,0,0,0,0,0
2017,194824,"Business Administration and Management, General",1,Bachelor's degree,69,55,14,0,0,0,3,2,1,2,2,0,6,4,2,0,0,0,49,40,9,3,3,0,1,0,1,5,4,1
2017,194824,"Business Administration and Management, General",1,Master's degree,34,17,17,0,0,0,4,3,1,0,0,0,2,1,1,0,0,0,12,9,3,0,0,0,1,0,1,15,4,11
2017,194824,"Logistics, Materials, and Supply Chain Management",1,Master's degree,0,0,0,0,0,0,0,0,0,0,0,0,0,0,0,0,0,0,0,0,0,0,0,0,0,0,0,0,0,0
2017,194824,Entrepreneurship/Entrepreneurial Studies,1,Master's degree,10,6,4,0,0,0,0,0,0,0,0,0,2,1,1,0,0,0,5,3,2,1,0,1,0,0,0,2,2,0
2017,194824,"Finance and Financial Management Services, Other",1,Master's degree,0,0,0,0,0,0,0,0,0,0,0,0,0,0,0,0,0,0,0,0,0,0,0,0,0,0,0,0,0,0
2017,194824,Business Statistics,1,Master's degree,29,14,15,0,0,0,0,0,0,2,2,0,1,1,0,0,0,0,4,2,2,1,1,0,2,0,2,19,8,11
2017,194824,"Management Sciences and Quantitative Methods, Other",1,Master's degree,17,10,7,0,0,0,1,0,1,1,1,0,0,0,0,0,0,0,5,5,0,0,0,0,0,0,0,10,4,6
2017,194824,"Business, Management, Marketing, and Related Support Services, Other",1,Master's degree,0,0,0,0,0,0,0,0,0,0,0,0,0,0,0,0,0,0,0,0,0,0,0,0,0,0,0,0,0,0
2017,194824,99,1,Bachelor's degree,1451,1028,423,0,0,0,160,107,53,23,17,6,120,87,33,0,0,0,909,657,252,81,55,26,30,18,12,128,87,41
2017,194824,99,1,Master's degree,429,300,129,0,0,0,30,22,8,8,5,3,24,18,6,0,0,0,199,152,47,11,9,2,7,4,3,150,90,60
